অ	ꯑ
অইং	ꯑꯏꯪ
অইংবা	ꯑꯏꯪꯕꯥ
অইবশিংনা	ꯑꯏꯕꯁꯤꯡꯅ
অইবশিংবু	ꯑꯏꯕꯁꯤꯡꯕꯨ
অইবা	ꯑꯏꯕꯥ
অইবী	ꯑꯏꯕꯤ
অইবীশিংনা	ꯑꯏꯕꯤꯁꯤꯡꯅ
অইবীশিংবু	ꯑꯏꯕꯤꯁꯤꯡꯕꯨ
অওক	ꯑꯑꯣꯛ
অওকশিং	ꯑꯑꯣꯛꯁꯤꯡ
অওকশিংদা	ꯑꯑꯣꯛꯁꯤꯗꯥ
অওনবশিং	ꯑꯑꯣꯟꯕꯁꯤꯡ
অওনবা	ꯑꯑꯣꯟꯕ
অকংবা	 ꯑꯀꯪꯕ
অকংবা	ꯑꯀꯪꯕ
অককনবা	ꯑꯀꯛꯅꯕ
অকক্নবা	ꯑꯀꯛꯅꯕ
অকনবা	ꯑꯀꯟꯕ
অকা	ꯑꯀꯥ
অকাই	ꯑꯀꯥꯢ
অকাইবা	ꯑꯀꯥꯢꯕ
অকামপাৎতা	ꯑꯀꯥꯝꯄꯥꯠꯇ
অকাম্পাৎনা	ꯑꯀꯥꯝꯄꯥꯠꯅ
অকাশবানি	ꯑꯀꯥꯁꯕꯥꯅꯤ
অকাস	ꯑꯀꯥꯁ
অকায়	ꯑꯀꯥꯢ
অকায়গী	ꯑꯀꯥꯢꯒꯤ
অকায়বা	ꯑꯀꯥꯢꯕ
অকায়শিং	ꯑꯀꯥꯢꯁꯤꯡ
অকি	ꯑꯀꯤ
অকিবগী	ꯑꯀꯤꯕꯒꯤ
অকিবনা	ꯑꯀꯤꯕꯅ
অকিবশিং	ꯑꯀꯤꯕꯁꯤꯡ
অকিবা	ꯑꯀꯤꯕ
অকুপ্পা	ꯑꯀꯨꯞꯄ
অকুম	ꯑꯀꯨꯝ
অকুৎপা	ꯑꯀꯨꯠꯄ
অকূপ্পা	 ꯑꯀꯨꯞꯄ
অকে	 ꯑꯀꯦ
অখং	ꯑꯈꯪ
অখঙ	ꯑꯈꯪ
অখঙবা	 ꯑꯈꯪꯕꯥ
অখন্ননা	ꯑꯈꯟꯅꯅꯥ
অখন্নবা	ꯑꯈꯟꯅꯕ
অখম	ꯑꯈꯝ
অখাকপা	ꯑꯈꯥꯛꯄ
অখাঙ	ꯑꯈꯥꯡ
অখাম	ꯑꯈꯥꯝ
অখিল	ꯑꯈꯤꯜ
অখুবা	 ꯑꯈꯨꯕꯥ
অখুম	 ꯑꯈꯨꯝ
অগনি	ꯑꯒꯅꯤ
অগরৱালনা	ꯑꯒꯔꯋꯥꯜꯅ
অগষ্ট	ꯑꯒꯁ꯭ꯇ
অগী	ꯑꯥꯒꯤ
অগে	 ꯑꯒꯦ
অগ্রাদা	ꯑꯒ꯭ꯔꯥꯗꯥ
অঙকপনা	 ꯑꯉꯛꯄꯅ
অঙকপা	ꯑꯉꯛꯄ
অঙনবদগী	ꯑꯉꯟꯕꯗꯒꯤ
অঙনবদা	ꯑꯉꯟꯕꯗ
অঙনবা	ꯑꯉꯟꯕ
অঙম	ꯑꯉꯝ
অঙম্বা	ꯑꯉꯝꯕ
অঙম্বী	ꯑꯉꯝꯕꯤ
অঙাং	ꯑꯉꯥꯡ
অঙাংগা	 ꯑꯉꯥꯪꯒꯥ
অঙাংগী	ꯑꯉꯥꯡꯒꯤ
অঙাংদা	ꯑꯉꯥꯡꯗꯥ
অঙাংদু	 ꯑꯉꯥꯡꯗꯨ
অঙাংদুগী	 ꯑꯉꯥꯡꯗꯨꯒꯤ
অঙাংনা	 ꯑꯉꯥꯡꯅ
অঙাংবা	ꯑꯉꯥꯡꯕ
অঙাংবু	 ꯑꯉꯥꯡꯕꯨ
অঙাংশিং	ꯑꯉꯥꯡꯁꯤꯡ
অঙাংশিংগা	ꯑꯉꯥꯡꯁꯤꯡꯒ
অঙাংশিংগী	ꯑꯉꯥꯡꯁꯤꯡꯒꯤ
অঙাংশিংগীদমক	ꯑꯉꯥꯡꯁꯤꯡꯒꯤꯗꯃꯛ
অঙাংশিংদগী	ꯑꯉꯥꯡꯁꯤꯡꯗꯒꯤ
অঙাংশিংদা	ꯑꯉꯥꯡꯁꯤꯡꯗꯥ
অঙাংশিংদি	ꯑꯉꯥꯡꯁꯤꯡꯗꯤ
অঙাংশিংনা	ꯑꯉꯥꯡꯁꯤꯡꯅꯥ
অঙাংশিংবু	ꯑꯉꯥꯡꯁꯤꯡꯕꯨ
অঙাংশিংসু	ꯑꯉꯥꯡꯁꯤꯡꯁꯨ
অঙাংহল	ꯑꯉꯥꯡꯍꯜ
অঙাওবা	ꯑꯉꯥꯎꯕ
অঙানবনা	ꯑꯉꯥꯟꯕꯅ
অঙাম	ꯑꯉꯥꯝ
অঙ্ক	ꯑꯪꯀ
অঙ্কগী	ꯑꯡꯀꯒꯤ
অঙ্গনৱাদি	ꯑꯡꯒꯟꯋꯥꯗꯤ
অচংবা	ꯑꯆꯪꯕ
অচম্বা	ꯑꯆꯝꯕ
অচা	ꯑꯆꯥ
অচাবা	ꯑꯆꯥꯕꯥ
অচার	ꯑꯆꯥꯔ
অচারিয়া	ꯑꯆꯥꯔꯤꯌꯥ
অচুম	ꯑꯆꯨꯃ
অচুম্বগী	ꯑꯆꯨꯝꯕꯒꯤ
অচুম্বগীদমক	ꯑꯆꯨꯝꯕꯒꯤꯗꯃꯛ
অচুম্বনা	ꯑꯆꯨꯝꯕꯅ
অচুম্বনি	ꯑꯆꯨꯝꯕꯅꯤ
অচুম্ববু	ꯑꯆꯨꯝꯕꯕꯨ
অচুম্বা	ꯑꯆꯨꯝꯕ
অচেৎপা	ꯑꯆꯦꯠꯄꯥ
অচৎ	ꯑꯆꯠ
অজ	ꯑꯖ
অজাদ	ꯑꯖꯥꯗ
অজিজুল	ꯑꯖꯤꯖꯨꯜ
অজিৎ	ꯑꯖꯤꯠ
অজয়	ꯑꯖꯌ
অটল	ꯑꯇꯜ
অটসুম	ꯑꯠꯁꯨꯝ
অটসুমগী	ꯑꯠꯁꯨꯝꯒꯤ
অতম্ননা	ꯑꯇꯝꯅꯅ
অতা	ꯑꯇꯥ
অতাংবা	ꯑꯇꯥꯡꯕ
অতাঙবা	ꯑꯇꯥꯡꯕꯥ
অতাবা	ꯑꯇꯥꯕ
অতিথি	ꯑꯇꯤꯊꯤ
অতিয়া	ꯑꯇꯤꯌꯥ
অতিয়াগী	ꯑꯇꯤꯌꯥꯒꯤ
অতিয়াদা	ꯑꯇꯤꯌꯥꯗ
অতেক	ꯑꯇꯦꯛ
অতেনবা	ꯑꯇꯦꯟꯕ
অতৈ	ꯑꯇꯩ
অতৈগা	ꯑꯇꯩꯒ
অতৈগী	ꯑꯇꯩꯒꯤ
অতৈদগী	ꯑꯇꯩꯗꯒꯤ
অতৈদসু	ꯑꯇꯩꯗꯁꯨ
অতৈদা	ꯑꯇꯩꯗ
অতৈদি	ꯑꯇꯩꯗꯤ
অতৈনা	ꯑꯇꯩꯅ
অত্মা	ꯑꯠꯃꯥ
অতৎ	ꯑꯇꯠ
অথক	ꯑꯊꯛ
অথকশিং	ꯑꯊꯛꯁꯤꯡ
অথাপ্পা	ꯑꯊꯥꯞꯄ
অথাবা	ꯑꯊꯥꯕ
অথিংবশিং	ꯑꯊꯤꯡꯕꯁꯤꯡ
অথিংবা	ꯑꯊꯤꯡꯕꯥ
অথুপ	ꯑꯊꯨꯞ
অথুবদা	ꯑꯊꯨꯕꯗꯥ
অথুবা	ꯑꯊꯨꯕꯥ
অথূপ্পা	ꯑꯊꯨꯞꯄꯥ
অথেংবদা	ꯑꯊꯦꯡꯕꯗꯥ
অথেংবা	ꯑꯊꯦꯡꯕꯥ
অদবানি	ꯑꯗꯕꯥꯅꯤ
অদর	ꯑꯗꯔ
অদা	ꯑꯗꯥ
অদানি	ꯑꯗꯥꯅꯤ
অদিতি	ꯑꯗꯤꯇꯤ
অদু	ꯑꯗꯨ
অদুক	ꯑꯗꯨꯀ
অদুক্কী	ꯑꯗꯨꯛꯀꯤ
অদুগা	ꯑꯗꯨꯒꯥ
অদুগী	ꯑꯗꯨꯒꯤ
অদুগীদমক	ꯑꯗꯨꯒꯤꯗꯃꯛ
অদুগীসু	ꯑꯗꯨꯒꯤꯁꯨ
অদুগুম্না	ꯑꯗꯨꯒꯨꯝꯅꯥ
অদুগুম্বা	ꯑꯗꯨꯒꯨꯝꯕꯥ
অদুঙৈ	ꯑꯗꯨꯉꯩ
অদুঙৈগী	ꯑꯗꯨꯉꯩꯒꯤ
অদুতনি	ꯑꯗꯨꯇꯅꯤ
অদুদ	ꯑꯗꯨꯗ
অদুদগী	ꯑꯗꯨꯗꯒꯤ
অদুদগীদি	ꯑꯗꯨꯗꯒꯤꯗꯤ
অদুদগীনি	ꯑꯗꯨꯗꯒꯤꯅꯤ
অদুদদি	ꯑꯗꯨꯗꯗꯤ
অদুদনা	ꯑꯗꯨꯗꯅꯥ
অদুদসু	ꯑꯗꯨꯗꯁꯨ
অদুদা	ꯑꯗꯨꯗꯥ
অদুদি	ꯑꯗꯨꯗꯤ
অদুদৈ	ꯑꯗꯨꯗꯩ
অদুন	ꯑꯗꯨꯅ
অদুনদি	ꯑꯗꯨꯅꯗꯤ
অদুননি	ꯑꯗꯨꯅꯅꯤ
অদুনা	ꯑꯗꯨꯅꯥ
অদুনি	ꯑꯗꯨꯅꯤ
অদুবু	ꯑꯗꯨꯕꯨ
অদুবুদি	ꯑꯗꯨꯕꯨꯗꯤ
অদুবুনা	ꯑꯗꯨꯕꯨꯅꯥ
অদুবুনি	ꯑꯗꯨꯕꯨꯅꯤ
অদুবুসু	ꯑꯗꯨꯕꯨꯁꯨ
অদুবূ	ꯑꯗꯨꯕꯨ
অদুম	ꯑꯗꯨꯝ
অদুমওইনমক	ꯑꯗꯨꯝꯑꯣꯏꯅꯃꯛ
অদুমক	ꯑꯗꯨꯃꯛ
অদুমকপু	ꯑꯗꯨꯃꯛꯄꯨ
অদুমক্কী	ꯑꯗꯨꯃꯛꯀꯤ
অদুমা	ꯑꯗꯨꯃꯥ
অদুম্নদি	ꯑꯗꯨꯝꯅꯗꯤ
অদুম্না	ꯑꯗꯨꯝꯅꯥ
অদুম্মক	ꯑꯗꯨꯝꯃꯛ
অদুম্মকপু	ꯑꯗꯨꯝꯃꯛꯄꯨ
অদুসু	ꯑꯗꯨꯁꯨ
অদুুবু	ꯑꯗꯨꯨꯕꯨ
অদুূগী	ꯑꯗꯨꯨꯒꯤ
অদুৱাইদদি	ꯑꯗꯨꯋꯥꯏꯗꯗꯤ
অদুৱাইদা	ꯑꯗꯨꯋꯥꯏꯗꯥ
অধার	ꯑꯙꯥꯔ
অধিকার	ꯑꯙꯤꯀꯥꯔ
অধিকারি	ꯑꯙꯤꯀꯥꯔꯤ
অন	ꯑꯅ
অনং	ꯑꯅꯪ
অনওর্গনাইজ	ꯑꯅꯑꯣꯔꯒꯅꯥꯏꯖ
অনকপদা	ꯑꯅꯛꯄꯗꯥ
অনন্দ	ꯑꯅꯟꯗ
অনন্দনা	ꯑꯅꯟꯗꯅꯥ
অনন্দা	ꯑꯅꯟꯗꯥ
অনসম	ꯑꯟꯁꯝ
অনা	ꯑꯅꯥ
অনাগী	ꯑꯅꯥꯒꯤ
অনাবগী	ꯑꯅꯥꯕꯒꯤ
অনাবদা	ꯑꯅꯥꯕꯗꯥ
অনাবনা	ꯑꯅꯥꯕꯅꯥ
অনাবশিং	ꯑꯅꯥꯕꯁꯤꯡ
অনাবশিংগা	ꯑꯅꯥꯕꯁꯤꯡꯒꯥ
অনাবশিংগী	ꯑꯅꯥꯕꯁꯤꯉꯒꯤ
অনাবশিংদা	ꯑꯅꯥꯕꯁꯤꯡꯗꯥ
অনাবশিংদি	ꯑꯅꯥꯕꯁꯤꯡꯗꯤ
অনাবশিংনা	ꯑꯅꯥꯕꯁꯤꯡꯅꯥ
অনাবশিংবু	ꯑꯅꯥꯕꯁꯤꯡꯕꯨ
অনাবা	ꯑꯅꯥꯕꯥ
অনাল	ꯑꯅꯥꯜ
অনি	ꯑꯅꯤ
অনিংবা	ꯑꯅꯤꯡꯕꯥ
অনিখক	ꯑꯅꯤꯈꯛ
অনিগা	ꯑꯅꯤꯒꯥ
অনিগী	ꯑꯅꯤꯒꯤ
অনিতা	ꯑꯅꯤꯇꯥ
অনিদগী	ꯑꯅꯤꯗꯒꯤ
অনিদা	ꯑꯅꯤꯗꯥ
অনিদি	ꯑꯅꯤꯗꯤ
অনিদু	ꯑꯅꯤꯗꯨ
অনিনা	ꯑꯅꯤꯅꯥ
অনিনি	ꯑꯅꯤꯅꯤ
অনিবু	ꯑꯅꯤꯕꯨ
অনিমক	ꯑꯅꯤꯃꯛ
অনিমক্কী	ꯑꯅꯤꯃꯛꯀꯤ
অনিমক্না	ꯑꯅꯤꯃꯛꯅꯥ
অনিরক	ꯑꯅꯤꯔꯛ
অনিরকশুবা	ꯑꯅꯤꯔꯛꯁꯨꯕꯥ
অনিল	ꯑꯅꯤꯜ
অনিশুবা	ꯑꯅꯤꯁꯨꯕꯥ
অনিসু	ꯑꯅꯤꯁꯨ
অনী	ꯑꯅꯤ
অনীংবা	ꯑꯅꯤꯪꯕꯥ
অনীখক	ꯑꯅꯤꯈꯛ
অনীগা	ꯑꯅꯤꯒꯥ
অনীগী	ꯑꯅꯤꯒꯤ
অনীদং	ꯑꯅꯤꯗꯪ
অনীদগী	ꯑꯅꯤꯗꯒꯤ
অনীদা	ꯑꯅꯤꯗꯥ
অনীদি	ꯑꯅꯤꯗꯤ
অনীদু	ꯑꯅꯤꯗꯨ
অনীদুগী	ꯑꯅꯤꯗꯨꯒꯤ
অনীদুদা	ꯑꯅꯤꯗꯨꯗꯥ
অনীদুদি	ꯑꯅꯤꯗꯨꯗꯤ
অনীদুনা	ꯑꯅꯤꯗꯨꯅꯥ
অনীনা	ꯑꯅꯤꯅꯥ
অনীবু	ꯑꯅꯤꯕꯨ
অনীমক	ꯑꯅꯤꯃꯛ
অনীমক্কী	ꯑꯅꯤꯃꯛꯀꯤ
অনীমক্না	ꯑꯅꯤꯃꯛꯅꯥ
অনীরক	ꯑꯅꯤꯔꯛ
অনীশুবা	ꯑꯅꯤꯁꯨꯕꯥ
অনীসি	ꯑꯅꯤꯁꯤ
অনীসিগী	ꯑꯅꯤꯁꯤꯒꯤ
অনীসু	ꯑꯅꯤꯁꯨ
অনুপম	ꯑꯅꯨꯄꯝ
অনেম্বা	ꯑꯅꯦꯝꯕꯥ
অন্তাস	ꯑꯟꯇꯥꯁ
অন্দমান	ꯑꯟꯗꯃꯥꯟ
অন্দর	ꯑꯟꯗꯔ
অন্দরষ্টেন্দিং	ꯑꯟꯗꯔꯁ꯭ꯇꯦꯟꯗꯤꯡ
অন্দামান	ꯑꯟꯗꯥꯃꯥꯟ
অন্দ্র	ꯑꯟꯗꯔ꯭
অন্ন	ꯑꯟꯅ
অন্না	ꯑꯟꯅꯥ
অপ	ꯑꯞ
অপগ্রেদ	ꯑꯞꯒ꯭ꯔꯦꯗ
অপগ্রেদেসন	ꯑꯞꯒ꯭ꯔꯦꯗꯦꯁꯟ
অপঙ	ꯑꯄꯡ
অপদেট	ꯑꯞꯗꯦꯇ
অপন	ꯑꯄꯟ
অপনদি	ꯑꯄꯟꯗꯤ
অপনবশিং	ꯑꯄꯟꯕꯁꯤꯡ
অপনবা	ꯑꯄꯟꯕꯥ
অপনা	ꯑꯄꯅꯥ
অপনি	ꯑꯄꯅꯤ
অপর	ꯑꯄꯔ
অপরাইজিং	ꯑꯞꯔꯥꯏꯖꯤꯡ
অপস	ꯑꯄꯁ
অপা	ꯑꯄꯥ
অপাইবী	ꯑꯄꯥꯏꯕꯤ
অপাবা	ꯑꯄꯥꯕꯥ
অপাম	ꯑꯄꯥꯃ
অপাম্বদি	ꯑꯄꯥꯝꯕꯗꯤ
অপাম্বদু	ꯑꯄꯥꯝꯕꯗꯨ
অপাম্বনি	ꯑꯄꯥꯝꯕꯅꯤ
অপাম্বশিং	ꯑꯄꯥꯝꯕꯁꯤꯡ
অপাম্বসু	ꯑꯄꯥꯝꯕꯁꯨ
অপাম্বা	ꯑꯄꯥꯝꯕꯥ
অপাশিং	ꯑꯄꯥꯁꯤꯡ
অপিকপা	ꯑꯄꯤꯛꯄꯥ
অপিবা	ꯑꯄꯤꯕꯥ
অপিল	ꯑꯄꯤꯜ
অপীক	ꯑꯄꯤꯛ
অপুন	ꯑꯄꯨꯅ
অপুনবগী	ꯑꯄꯨꯅꯕꯒꯤ
অপুনবা	ꯑꯄꯨꯅꯕꯥ
অপুন্নবা	ꯑꯄꯨꯟꯅꯕꯥ
অপুম	ꯑꯄꯨꯃ
অপুম্বা	ꯑꯄꯨꯝꯕꯥ
অপূনবা	ꯑꯄꯨꯅꯕꯥ
অপূম্বা	ꯑꯄꯨꯝꯕꯥ
অপেন	ꯑꯄꯦꯟ
অপেনবা	ꯑꯄꯦꯟꯕꯥ
অপ্পর	ꯑꯞꯄꯔ
অফ	ꯑꯐ
অফং	ꯑꯐꯪ
অফংবা	ꯑꯐꯪꯕꯥ
অফগান	ꯑꯐꯒꯥꯟ
অফগানিষ্টান	ꯑꯐꯒꯥꯅꯤꯁꯇꯥꯟ
অফগানিষ্টানদা	ꯑꯐꯒꯥꯅꯤꯁꯇꯥꯟꯗꯥ
অফবনা	ꯑꯐꯕꯅꯥ
অফবা	ꯑꯐꯕꯥ
অফস্পা	ꯑꯐꯁꯄꯥ
অফা	ꯑꯐꯥ
অফাও	ꯑꯐꯥꯎ
অফাওবা	ꯑꯐꯥꯑꯣꯕꯥ
অবদেল	ꯑꯕꯗꯦꯜ
অবা	ꯑꯕꯥ
অবাবা	ꯑꯕꯥꯕꯥ
অবের	ꯑꯕꯦꯔ
অব্দুল	ꯑꯕꯗꯨꯜ
অব্দুলা	ꯑꯕꯗꯨꯂꯥ
অভিজিৎ	ꯑꯚꯤꯖꯤꯠ
অভিয়ান	ꯑꯚꯤꯌꯥꯟ
অভিয়ানগী	ꯑꯚꯤꯌꯥꯟꯒꯤ
অম	ꯑꯃ
অমকপা	ꯑꯃꯛꯄꯥ
অমখক	ꯑꯃꯈꯛ
অমখক্কী	ꯑꯃꯈꯛꯀꯤ
অমগগী	ꯑꯃꯒꯒꯤ
অমগনা	ꯑꯃꯒꯅꯥ
অমগনি	ꯑꯃꯒꯅꯤ
অমগসু	ꯑꯃꯒꯁꯨ
অমগা	ꯑꯃꯒꯥ
অমগী	ꯑꯃꯒꯤ
অমগীদমক	ꯑꯃꯒꯤꯗꯃꯛ
অমগীদা	ꯑꯃꯒꯤꯗꯥ
অমগীনা	ꯑꯃꯒꯤꯅꯥ
অমগীনি	ꯑꯃꯒꯤꯅꯤ
অমগীসু	ꯑꯃꯒꯤꯁꯨ
অমগুম	ꯑꯃꯒꯨꯝ
অমগুম্না	ꯑꯃꯒꯨꯝꯅꯥ
অমজু	ꯑꯝꯖꯨ
অমজুগী	ꯑꯝꯖꯨꯒꯤ
অমতং	ꯑꯃꯇꯪ
অমতনা	ꯑꯃꯠꯅꯥ
অমতা	ꯑꯃꯇꯥ
অমত্তং	ꯑꯃꯠꯇꯪ
অমত্তগা	ꯑꯃꯠꯇꯒꯥ
অমত্তগী	ꯑꯃꯠꯇꯒꯤ
অমত্তদা	ꯑꯃꯠꯇꯗꯥ
অমত্তদি	ꯑꯃꯠꯇꯗꯤ
অমত্তনসু	ꯑꯃꯠꯇꯅꯁꯨ
অমত্তনা	ꯑꯃꯠꯇꯅꯥ
অমত্তনি	ꯑꯃꯠꯇꯅꯤ
অমত্তসু	ꯑꯃꯠꯇꯁꯨ
অমত্তা	ꯑꯃꯠꯇꯥ
অমদ	ꯑꯃꯗ
অমদগী	ꯑꯃꯗꯒꯤ
অমদগীদি	ꯑꯃꯗꯒꯤꯗꯤ
অমদনা	ꯑꯃꯗꯅꯥ
অমদনি	ꯑꯃꯗꯅꯤ
অমদসু	ꯑꯃꯗꯁꯨ
অমদা	ꯑꯃꯗꯥ
অমদি	ꯑꯃꯗꯤ
অমদু	ꯑꯃꯗꯨ
অমদুনা	ꯑꯃꯗꯨꯅꯥ
অমনবা	ꯑꯃꯟꯕꯥ
অমনসু	ꯑꯃꯅꯁꯨ
অমনা	ꯑꯃꯅꯥ
অমনি	ꯑꯃꯅꯤ
অমফাওবা	ꯑꯃꯐꯥꯑꯣꯕꯥ
অমবু	ꯑꯃꯕꯨ
অমবুদি	ꯑꯃꯕꯨꯗꯤ
অমব্রেলা	ꯑꯝꯕ꯭ꯔꯦꯂꯥ
অমমম	ꯑꯃꯃꯝ
অমমমগী	ꯑꯃꯃꯝꯒꯤ
অমমমতা	ꯑꯃꯃꯝꯇꯥ
অমমমদা	ꯑꯃꯃꯝꯗꯥ
অমমমদি	ꯑꯃꯃꯝꯗꯤ
অমমমনা	ꯑꯃꯃꯝꯅꯥ
অমমমনি	ꯑꯃꯃꯝꯅꯤ
অমমমম	ꯑꯝꯃꯃꯝ
অমমুক	ꯑꯃꯃꯨꯛ
অমম্বদা	ꯑꯃꯝꯕꯗꯥ
অমম্ববু	ꯑꯃꯝꯕꯕꯨ
অমম্বা	ꯑꯃꯝꯕꯥ
অমর	ꯑꯃꯔ
অমরজিৎ	ꯑꯃꯔꯖꯤꯠ
অমরা	ꯑꯝꯔꯥ
অমরিন্দর	ꯑꯝꯔꯤꯟꯗꯔ
অমরেমদা	ꯑꯃꯔꯦꯝꯗꯥ
অমসিদা	ꯑꯃꯁꯤꯗꯥ
অমসু	ꯑꯃꯁꯨ
অমসুং	ꯑꯃꯁꯨꯡ
অমসুনি	ꯑꯃꯁꯨꯅꯤ
অমা	ꯑꯃꯥ
অমাং	ꯑꯃꯥꯡ
অমাংবা	ꯑꯃꯥꯡꯕꯥ
অমাইবা	ꯑꯃꯥꯢꯕꯥ
অমাইবীশিংনসু	ꯑꯃꯥꯢꯕꯤꯁꯤꯡꯅꯁꯨ
অমাগী	ꯑꯃꯥꯒꯤ
অমাঙ	ꯑꯃꯥꯉ
অমানা	ꯑꯃꯥꯅꯥ
অমিট	ꯑꯃꯤꯠ
অমিত	ꯑꯃꯤꯠ
অমিন	ꯑꯃꯤꯟ
অমুক	ꯑꯃꯨꯛ
অমুক্কসু	ꯑꯃꯨꯛꯀꯁꯨ
অমুক্কা	ꯑꯃꯨꯛꯀꯥ
অমুবা	ꯑꯃꯨꯕꯥ
অমুর	ꯑꯃꯨꯔ
অমেরিকা	ꯑꯃꯦꯔꯤꯀꯥ
অমেরিকাগী	ꯑꯃꯦꯔꯤꯀꯥꯒꯤ
অমেরিকাদা	ꯑꯃꯦꯔꯤꯀꯥꯗꯥ
অম্ফা	ꯑꯝꯐꯥ
অরাং	ꯑꯔꯥꯪ
অরাইবা	ꯑꯔꯥꯢꯕꯥ
অরান	ꯑꯔꯥꯟ
অরানবনি	ꯑꯔꯥꯟꯕꯅꯤ
অরানবশিং	ꯑꯔꯥꯟꯕꯁꯤꯡ
অরানবা	ꯑꯔꯥꯟꯕꯥ
অরাপ্তি	ꯑꯔꯥꯞꯇꯤ
অরাপ্পদা	ꯑꯔꯥꯞꯄꯗꯥ
অরাপ্পা	ꯑꯔꯥꯞꯄꯥ
অরাবিয়া	ꯑꯔꯥꯕꯤꯌꯥ
অরাবিয়াগী	ꯑꯔꯥꯕꯤꯌꯥꯒꯤ
অরাবিয়াদগী	ꯑꯔꯥꯕꯤꯌꯥꯗꯒꯤ
অরাবিয়ানা	ꯑꯔꯥꯕꯤꯌꯥꯅꯥ
অরাম	ꯑꯔꯥꯃ
অরাম্বম	ꯑꯔꯥꯝꯕꯝ
অরাম্বমনা	ꯑꯔꯥꯝꯕꯝꯅꯥ
অরি	ꯑꯔꯤ
অরিবম	ꯑꯔꯤꯕꯝ
অরিবা	ꯑꯔꯤꯕꯥ
অরু	ꯑꯔꯨ
অরুন	ꯑꯔꯨꯟ
অরুনকুমারনা	ꯑꯔꯨꯟꯀꯨꯃꯥꯔꯅꯥ
অরুনাচল	ꯑꯔꯨꯅꯥꯆꯜ
অরুবা	ꯑꯔꯨꯕꯥ
অরুম্বগী	ꯑꯔꯨꯝꯕꯒꯤ
অরুম্বনা	ꯑꯔꯨꯝꯕꯅꯥ
অরুম্বা	ꯑꯔꯨꯝꯕꯥ
অরেপ্পা	ꯑꯔꯦꯞꯄꯥ
অরেম্বদা	ꯑꯔꯦꯝꯕꯗꯥ
অরেম্বা	ꯑꯔꯦꯝꯕꯥ
অরৈবা	ꯑꯔꯩꯕꯥ
অর্থর	ꯑꯔꯊꯔ
অর্বান	ꯑꯔꯕꯥꯟ
অর্বানগী	ꯑꯔꯕꯥꯟꯒꯤ
অর্শিবাদ	ꯑꯔꯁꯤꯕꯥꯗ
অল	ꯑꯜ
অলফ্রেদ	ꯑꯜꯐ꯭ꯔꯦꯗ
অলম	ꯑꯂꯝ
অশংবা	ꯑꯁꯪꯕꯥ
অশম্বা	ꯑꯁꯝꯕꯥ
অশা	ꯑꯁꯥ
অশাংবম	ꯑꯁꯥꯡꯕꯝ
অশাংবা	ꯑꯁꯥꯡꯕꯥ
অশাওবা	ꯑꯁꯥꯑꯣꯕꯥ
অশাগী	ꯑꯁꯥꯒꯤ
অশানবা	ꯑꯁꯥꯟꯕꯥ
অশাবদু	ꯑꯁꯥꯕꯗꯨ
অশাবা	ꯑꯁꯥꯕꯥ
অশি	ꯑꯁꯤ
অশিং	ꯑꯁꯤꯪ
অশিংবনি	ꯑꯁꯤꯡꯕꯅꯤ
অশিংবা	ꯑꯁꯤꯪꯕꯥ
অশিবগী	ꯑꯁꯤꯕꯒꯤ
অশিবগুম	ꯑꯁꯤꯕꯒꯨꯃ
অশিবা	ꯑꯁꯤꯕꯥ
অশুক	ꯑꯁꯨꯛ
অশুকপা	ꯑꯁꯨꯛꯄꯥ
অশেংবদু	ꯑꯁꯦꯪꯕꯗꯨ
অশেংবনি	ꯑꯁꯦꯪꯕꯅꯤ
অশেংবা	ꯑꯁꯦꯡꯕꯥ
অশেম	ꯑꯁꯦꯝ
অসব	ꯑꯁꯕ
অসা	ꯑꯁꯥ
অসাম	ꯑꯁꯥꯝ
অসামগা	ꯑꯁꯥꯝꯒꯥ
অসামগী	ꯑꯁꯥꯃꯒꯤ
অসামদগী	ꯑꯁꯥꯝꯗꯒꯤ
অসামদা	ꯑꯁꯥꯝꯗꯥ
অসামনা	ꯑꯁꯥꯝꯅꯥ
অসামবু	ꯑꯁꯥꯝꯕꯨ
অসি	ꯑꯁꯤ
অসিগা	ꯑꯁꯤꯒꯥ
অসিগী	ꯑꯁꯤꯒꯤ
অসিগীতা	ꯑꯁꯤꯒꯤꯇꯥ
অসিগীদমক	ꯑꯁꯤꯒꯤꯗꯃꯛ
অসিগীসু	ꯑꯁꯤꯒꯤꯁꯨ
অসিগুমবা	ꯑꯁꯤꯒꯨꯝꯕꯥ
অসিগুম্না	ꯑꯁꯤꯒꯨꯝꯅꯥ
অসিগুম্বশিং	ꯑꯁꯤꯒꯨꯝꯕꯁꯤꯡ
অসিগুম্বা	ꯑꯁꯤꯒꯨꯝꯕꯥ
অসিগুম্লবা	ꯑꯁꯤꯒꯨꯝꯂꯕꯥ
অসিদগী	ꯑꯁꯤꯗꯒꯤ
অসিদগীনি	ꯑꯁꯤꯗꯒꯤꯅꯤ
অসিদতা	ꯑꯁꯤꯗꯇꯥ
অসিদদি	ꯑꯁꯤꯗꯗꯤ
অসিদনা	ꯑꯁꯤꯗꯅꯥ
অসিদনি	ꯑꯁꯤꯗꯅꯤ
অসিদসু	ꯑꯁꯤꯗꯁꯨ
অসিদা	ꯑꯁꯤꯗꯥ
অসিদি	ꯑꯁꯤꯗꯤ
অসিন	ꯑꯁꯤꯅ
অসিনচিংবগী	ꯑꯁꯤꯅꯆꯤꯡꯕꯒꯤ
অসিনচিংবনি	ꯑꯁꯤꯅꯆꯤꯡꯕꯅꯤ
অসিনচিংবা	ꯑꯁꯤꯅꯆꯤꯪꯕꯥ
অসিননি	ꯑꯁꯤꯅꯅꯤ
অসিনসু	ꯑꯁꯤꯅꯁꯨ
অসিনা	ꯑꯁꯤꯅꯥ
অসিনি	ꯑꯁꯤꯅꯤ
অসিবু	ꯑꯁꯤꯕꯨ
অসিবুসু	ꯑꯁꯤꯕꯨꯁꯨ
অসিমক	ꯑꯁꯤꯃꯛ
অসিমক্কী	ꯑꯁꯤꯃꯛꯀꯤ
অসিমক্না	ꯑꯁꯤꯃꯛꯅꯥ
অসিমদি	ꯑꯁꯤꯃꯗꯤ
অসিমসু	ꯑꯁꯤꯃꯁꯨ
অসিমা	ꯑꯁꯤꯃꯥ
অসিস	ꯑꯁꯤꯁ
অসিসু	ꯑꯁꯤꯁꯨ
অসিা	ꯑꯁꯤ
অসিৱাইদা	ꯑꯁꯤꯋꯥꯏꯗꯥ
অসুক	ꯑꯁꯨꯀ
অসুক্কী	ꯑꯁꯨꯛꯀꯤ
অসুম	ꯑꯁꯨꯝ
অসুম্না	ꯑꯁꯨꯝꯅꯥ
অসে	ꯑꯁꯦ
অহকপা	ꯑꯍꯛꯄꯥ
অহন	ꯑꯍꯟ
অহন্থেম	ꯑꯍꯟꯊꯦꯝ
অহমদ	ꯑꯍꯃꯗ
অহল	ꯑꯍꯜ
অহলশিং	ꯑꯍꯜꯁꯤꯡ
অহলশিংদা	ꯑꯍꯜꯁꯤꯡꯗꯥ
অহল্লুপ	ꯑꯍꯜꯂꯨꯞ
অহাংবা	ꯑꯍꯥꯡꯕꯥ
অহাওবা	ꯑꯍꯥꯑꯣꯕꯥ
অহান	ꯑꯍꯥꯟ
অহানবগী	ꯑꯍꯥꯟꯕꯒꯤ
অহানবদা	ꯑꯍꯥꯟꯕꯗꯥ
অহানবনি	ꯑꯍꯥꯟꯕꯅꯤ
অহানবা	ꯑꯍꯥꯟꯕꯥ
অহাবা	ꯑꯍꯥꯕꯥ
অহিং	ꯑꯍꯤꯡ
অহিংগী	ꯑꯍꯤꯡꯒꯤ
অহিংদগী	ꯑꯍꯤꯡꯗꯒꯤ
অহিংদা	ꯑꯍꯤꯡꯗꯥ
অহিংদু	ꯑꯍꯤꯪꯗꯨ
অহিংদুদা	ꯑꯍꯤꯪꯗꯨꯗꯥ
অহিংবা	ꯑꯍꯤꯪꯕꯥ
অহুম	ꯑꯍꯨꯝ
অহুমখক	ꯑꯍꯨꯝꯈꯛ
অহুমগা	ꯑꯍꯨꯝꯒꯥ
অহুমগী	ꯑꯍꯨꯝꯒꯤ
অহুমদগী	ꯑꯍꯨꯝꯗꯒꯤ
অহুমদা	ꯑꯍꯨꯝꯗꯥ
অহুমদি	ꯑꯍꯨꯝꯗꯤ
অহুমনা	ꯑꯍꯨꯝꯅꯥ
অহুমনি	ꯑꯍꯨꯝꯅꯤ
অহুমবু	ꯑꯍꯨꯝꯕꯨ
অহুমলক	ꯑꯍꯨꯝꯂꯛ
অহুমলকশুবা	ꯑꯍꯨꯝꯂꯛꯁꯨꯕꯥ
অহুমশুবদা	ꯑꯍꯨꯝꯁꯨꯕꯗꯥ
অহুমশুবনা	ꯑꯍꯨꯝꯁꯨꯕꯅꯥ
অহুমশুবা	ꯑꯍꯨꯝꯁꯨꯕꯥ
অহুমসু	ꯑꯍꯨꯝꯁꯨ
অহুম্না	ꯑꯍꯨꯝꯅꯥ
অহুম্নি	ꯑꯍꯨꯝꯅꯤ
অহুম্মক	ꯑꯍꯨꯝꯃꯛ
অহুম্মক্কী	ꯑꯍꯨꯝꯃꯛꯀꯤ
অহুম্লক	ꯑꯍꯨꯝꯂꯛ
অহেন	ꯑꯍꯦꯟ
অহেনবা	ꯑꯍꯦꯟꯕꯥ
অহৈ	ꯑꯍꯩ
অহৈবা	ꯑꯍꯩꯕꯥ
অহৈশিং	ꯑꯍꯩꯁꯤꯡ
অহৈশিংগা	ꯑꯍꯩꯁꯤꯡꯒꯥ
অহৈশিংগী	ꯑꯍꯩꯁꯤꯡꯒꯤ
অহৈশিংনা	ꯑꯍꯩꯁꯤꯡꯅꯥ
অয়া	ꯑꯌꯥ
অয়াবদু	ꯑꯌꯥꯕꯗꯨ
অয়াবসু	ꯑꯌꯥꯕꯁꯨ
অয়াবা	ꯑꯌꯥꯕꯥ
অয়াম্বগী	ꯑꯌꯥꯝꯕꯒꯤ
অয়াম্বদা	ꯑꯌꯥꯝꯕꯗꯥ
অয়াম্বদি	ꯑꯌꯥꯝꯕꯗꯤ
অয়াম্বনা	ꯑꯌꯥꯝꯕꯅꯥ
অয়াম্বনি	ꯑꯌꯥꯝꯕꯅꯤ
অয়াম্বা	ꯑꯌꯥꯝꯕꯥ
অয়ুক	ꯑꯌꯨꯛ
অয়ুক্কি	ꯑꯌꯨꯛꯀꯤ
অয়ুক্কী	ꯑꯌꯨꯛꯀꯤ
অয়ুরবেদনা	ꯑꯌꯨꯔꯕꯦꯗꯅꯥ
অয়ূক	ꯑꯌꯨꯀ
অয়েংবা	ꯑꯌꯦꯪꯕꯥ
অয়েক	ꯑꯌꯦꯛ
অয়েকপম	ꯑꯌꯦꯛꯄꯝ
অয়েকপা	ꯑꯌꯦꯛꯄꯥ
অয়েৎ	ꯑꯌꯦꯠ
অয়েৎপা	ꯑꯌꯦꯠꯄꯥ
অৱা	ꯑꯋꯥ
অৱাং	ꯑꯋꯥꯡ
অৱাংখুল	ꯑꯋꯥꯡꯈꯨꯜ
অৱাংগী	ꯑꯋꯥꯪꯒꯤ
অৱাংথংবা	ꯑꯋꯥꯪꯊꯪꯕꯥ
অৱাংদা	ꯑꯋꯥꯡꯗꯥ
অৱাংবা	ꯑꯋꯥꯡꯕꯥ
অৱাবগা	ꯑꯋꯥꯕꯒꯥ
অৱাবগী	ꯑꯋꯥꯕꯒꯤ
অৱাবদসু	ꯑꯋꯥꯕꯗꯁꯨ
অৱাবদা	ꯑꯋꯥꯕꯗꯥ
অৱাবদু	ꯑꯋꯥꯕꯗꯨ
অৱাবনা	ꯑꯋꯥꯕꯅꯥ
অৱাবশিং	ꯑꯋꯥꯕꯁꯤꯡ
অৱাবসি	ꯑꯋꯥꯕꯁꯤ
অৱাবা	ꯑꯋꯥꯕꯥ
অৱার	ꯑꯋꯥꯔ
অৱারগী	ꯑꯋꯥꯔꯒꯤ
অৱাস	ꯑꯋꯥꯁ
অৱাৎ	ꯑꯋꯥꯠ
অৱাৎপনা	ꯑꯋꯥꯠꯄꯅꯥ
অৱাৎপশিং	ꯑꯋꯥꯠꯄꯁꯤꯡ
অৱাৎপা	ꯑꯋꯥꯠꯄꯥ
অৱায়	ꯑꯋꯥꯌ
আ	ꯑꯥ
আই	ꯑꯥꯏ
আইএমনা	ꯑꯥꯢꯑꯦꯝꯅꯥ
আইগী	ꯑꯥꯢꯒꯤ
আইজিএআর	ꯑꯥꯏꯖꯤꯑꯦꯑꯥꯔ
আইট	ꯑꯥꯏꯠ
আইটতা	ꯑꯥꯏꯠꯇꯥ
আইদিয়া	ꯑꯥꯏꯗꯤꯌꯥ
আইদেল	ꯑꯥꯏꯗꯦꯜ
আইন	ꯑꯥꯏꯟ
আইন	ꯑꯥꯢꯟ
আইনগী	ꯑꯥꯏꯟꯒꯤ
আইননা	ꯑꯥꯏꯟꯅꯥ
আইনশিং	ꯑꯥꯏꯟꯁꯤꯡ
আইন্না	ꯑꯥꯏꯟꯅꯥ
আইরন	ꯑꯥꯏꯔꯟ
আইলেন্দদা	ꯑꯥꯏꯂꯦꯟꯗꯗꯥ
আইসি	ꯑꯥꯏꯁꯤ
আইয়রলেন্দ	ꯑꯥꯏꯌꯔꯂꯦꯟꯗ
আগরৱাল	ꯑꯥꯒꯔꯋꯥꯜ
আগষ্ট	ꯑꯥꯒꯁ꯭ꯇ
আগষ্টকী	ꯑꯥꯒꯁ꯭ꯇꯀꯤ
আগষ্টতা	ꯑꯥꯒꯁ꯭ꯇꯇꯥ
আত্মা	ꯑꯥꯠꯃꯥ
আদমি	ꯑꯥꯗꯃꯤ
আদা	ꯑꯥꯗꯥ
আধার	ꯑꯥꯙꯥꯔ
আনন্দ	ꯑꯥꯅꯟꯗ
আনিল	ꯑꯥꯅꯤꯜ
আপিল	ꯑꯥꯄꯤꯜ
আপীল	ꯑꯥꯄꯤꯜ
আফ্রিকা	ꯑꯥꯐ꯭ꯔꯤꯀꯥ
আফ্রিকাদা	ꯑꯥꯐ꯭ꯔꯤꯀꯥꯗꯥ
আফ্রিকান	ꯑꯥꯐ꯭ꯔꯤꯀꯥꯅ
আম	ꯑꯥꯃ
আমর্দ	ꯑꯥꯝꯔꯗ
আমেরিকা	ꯑꯥꯃꯦꯔꯤꯀꯥ
আমেরিকাগা	ꯑꯥꯃꯦꯔꯤꯀꯥꯒꯥ
আমেরিকাগী	ꯑꯥꯃꯦꯔꯤꯀꯥꯒꯤ
আর	ꯑꯥꯔ
আরগী	ꯑꯥꯔꯒꯤ
আরজি	ꯑꯥꯔꯖꯤ
আরটি	ꯑꯥꯔꯇꯤ
আরব	ꯑꯥꯔꯕ
আর্কাইব	ꯑꯥꯔꯀꯥꯢꯕ
আর্চরি	ꯑꯥꯔꯆꯔꯤ
আর্ট	ꯑꯥꯔꯠ
আর্টস	ꯑꯥꯔꯠꯁ
আর্টসকী	ꯑꯥꯔꯠꯁꯀꯤ
আর্টসতা	ꯑꯥꯔꯠꯁꯇꯥ
আর্টি	ꯑꯥꯔꯇꯤ
আর্টিকল	ꯑꯥꯔꯇꯤꯀꯜ
আর্টিফিসিয়েল	ꯑꯥꯔꯇꯤꯐꯤꯁꯤꯌꯦꯜ
আর্টিষ্ট	ꯑꯥꯔꯇꯤꯁꯇ
আর্টিষ্টনি	ꯑꯥꯔꯇꯤꯁ꯭ꯇꯅꯤ
আর্টিষ্টশিং	ꯑꯥꯔꯇꯤꯁ꯭ꯇꯁꯤꯡ
আর্টিষ্টশিংগী	ꯑꯥꯔꯇꯤꯁ꯭ꯇꯁꯤꯡꯒꯤ
আর্টিষ্টশিংদগী	ꯑꯥꯔꯇꯤꯁ꯭ꯇꯁꯤꯡꯗꯒꯤ
আর্টিষ্টশিংদা	ꯑꯥꯔꯇꯤꯁ꯭ꯇꯁꯤꯡꯗꯥ
আর্টিষ্টশিংনা	ꯑꯥꯔꯇꯤꯁ꯭ꯇꯁꯤꯡꯅꯥ
আর্টিষ্টশিংবু	ꯑꯥꯔꯇꯤꯁ꯭ꯇꯁꯤꯡꯕꯨ
আর্টিসান	ꯑꯥꯔꯇꯤꯁꯥꯟ
আর্টিসানশিংগী	ꯑꯥꯔꯇꯤꯁꯥꯟꯁꯤꯡꯒꯤ
আর্টিসানশিংদা	ꯑꯥꯔꯇꯤꯁꯥꯟꯁꯤꯡꯗꯥ
আর্টিসানশিংনা	ꯑꯥꯔꯇꯤꯁꯥꯟꯁꯤꯡꯅꯥ
আর্থ	ꯑꯥꯔꯊ
আর্থদি	ꯑꯥꯔꯊꯗꯤ
আর্ম	ꯑꯥꯔꯝ
আর্মদ	ꯑꯥꯔꯝꯗ
আর্মি	ꯑꯥꯔꯃꯤ
আর্মিগী	ꯑꯥꯔꯃꯤꯒꯤ
আর্মিদগী	ꯑꯥꯔꯃꯤꯗꯒꯤ
আর্মিদা	ꯑꯥꯔꯃꯤꯗꯥ
আর্মিনা	ꯑꯥꯔꯃꯤꯅꯥ
আলি	ꯑꯥꯂꯤ
আলিগর	ꯑꯥꯂꯤꯒꯔ
আলু	ꯑꯥꯂꯨ
আশা	ꯑꯥꯁꯥ
আশাগা	ꯑꯥꯁꯥꯒꯥ
আশাগী	ꯑꯥꯁꯥꯒꯤ
আশানা	ꯑꯥꯁꯥꯅꯥ
আশাশিং	ꯑꯥꯁꯥꯁꯤꯡ
আশাসু	ꯑꯥꯁꯥꯁꯨ
আশ্রম	ꯑꯥꯁ꯭ꯔꯝ
আশ্রমগী	ꯑꯥꯁ꯭ꯔꯝꯒꯤ
আষ্ট্রেলিয়া	ꯑꯥꯁꯇ꯭ꯔꯦꯂꯤꯌꯥ
আষ্ট্রেলিয়াদা	ꯑꯥꯁꯇ꯭ꯔꯦꯂꯤꯌꯥꯗꯥ
আষ্ট্রেলিয়ান	ꯑꯥꯁꯇ꯭ꯔꯦꯂꯤꯌꯥꯟ
আসাম	ꯑꯥꯁꯥꯝ
আসামগী	ꯑꯥꯁꯥꯝꯒꯤ
ই	ꯏ
ইং	ꯏꯪ
ইংগী	ꯏꯪꯒꯤ
ইংগ্রাজি	ꯏꯪꯒ꯭ꯔꯥꯖꯤ
ইংগ্রাজিদা	ꯏꯪꯒ꯭ꯔꯥꯖꯤꯗꯥ
ইংনা	ꯏꯪꯅꯥ
ইংবা	ꯏꯪꯕꯥ
ইংরাজি	ꯏꯪꯔꯥꯖꯤ
ইংরাজিদা	ꯏꯪꯔꯥꯖꯤꯗꯥ
ইংলিস	ꯏꯪꯂꯤꯁ
ইংলিসকী	ꯏꯪꯂꯤꯁꯀꯤ
ইংলিসতা	ꯏꯪꯂꯤꯁꯇꯥ
ইংলেন্দ	ꯏꯪꯂꯦꯟꯗ
ইংলেন্দদা	ꯏꯪꯂꯦꯟꯗꯗꯥ
ইওন	ꯏꯑꯣꯅ
ইকং	ꯏꯀꯪ
ইকাই	ꯏꯀꯥꯢ
ইকান	ꯏꯀꯥꯟ
ইকায়	ꯏꯀꯥꯌ
ইকায়খুম্নবা	ꯏꯀꯥꯌꯈꯨꯝꯅꯕꯥ
ইকায়নিংঙাইনি	ꯏꯀꯥꯌꯅꯤꯡꯉꯥꯢꯅꯤ
ইকায়বা	ꯏꯀꯥꯌꯕꯥ
ইকুই	ꯏꯀꯨꯏ
ইক্বিপমেন্ট	ꯏꯀ꯭ꯋꯤꯞꯃꯦꯟꯇ
ইখং	ꯏꯈꯪ
ইখঙ	ꯏꯈꯡ
ইখন	ꯏꯈꯟ
ইখি	ꯏꯈꯤ
ইখ্রে	ꯏꯈ꯭ꯔꯦ
ইগজাম	ꯏꯒꯖꯥꯝ
ইগজামগী	ꯏꯒꯖꯥꯝꯒꯤ
ইগজামশিং	ꯏꯒꯖꯥꯝꯁꯤꯡ
ইগজামিনেসন	ꯏꯒꯖꯥꯃꯤꯅꯦꯁꯟ
ইগজামিনেসনগী	ꯏꯒꯖꯥꯃꯤꯅꯦꯁꯟꯒꯤ
ইগজামিনেসনদা	ꯏꯒꯖꯥꯃꯤꯅꯦꯁꯟꯗꯥ
ইগজিবিসন	ꯏꯒꯖꯤꯕꯤꯁꯟ
ইগী	ꯏꯒꯤ
ইঙক	ꯏꯉꯛ
ইঙা	ꯏꯉꯥ
ইঙাং	ꯏꯉꯥꯡ
ইঙেন	ꯏꯉꯦꯅ
ইচং	ꯏꯆꯪ
ইচম	ꯏꯆꯝ
ইচল	ꯏꯆꯜ
ইচলগী	ꯏꯆꯜꯒꯤ
ইচা	ꯏꯆꯥ
ইচাগী	ꯏꯆꯥꯒꯤ
ইচাদু	ꯏꯆꯥꯗꯨ
ইচানুপী	ꯏꯆꯥꯅꯨꯄꯤ
ইচাবু	ꯏꯆꯥꯕꯨ
ইচি	ꯏꯆꯤ
ইচিন	ꯏꯆꯤꯟ
ইচিল	ꯏꯆꯤꯜ
ইচে	ꯏꯆꯦ
ইচেগী	ꯏꯆꯦꯒꯤ
ইচেন	ꯏꯆꯦꯟ
ইচেনা	ꯏꯆꯦꯅꯥ
ইচেল	ꯏꯆꯦꯜ
ইজ	ꯏꯖ
ইজরেল	ꯏꯖꯔꯦꯜ
ইজরেলগী	ꯏꯖꯔꯦꯜꯒꯤ
ইজরেলদা	ꯏꯖꯔꯦꯜꯗꯥ
ইজরেলনা	ꯏꯖꯔꯦꯜꯅꯥ
ইজিপকী	ꯏꯖꯤꯞꯀꯤ
ইজিপতা	ꯏꯖꯤꯞꯇꯥ
ইজৈ	ꯏꯖꯩ
ইজ্জৎ	ꯏꯖꯖꯠ
ইজৎ	ꯏꯖꯠ
ইঞ্চি	ꯏꯟꯆꯤ
ইঞ্ছাং	ꯏꯟꯁꯥꯡ
ইঞ্জিন	ꯏꯟꯖꯤꯟ
ইঞ্জিনগী	ꯏꯟꯖꯤꯟꯒꯤ
ইঞ্জিনিয়ার	ꯏꯟꯖꯤꯅꯤꯌꯥꯔ
ইঞ্জিনিয়ারশিং	ꯏꯟꯖꯤꯅꯤꯌꯥꯔꯁꯤꯡ
ইঞ্জিনিয়ারশিংনা	ꯏꯟꯖꯤꯅꯤꯌꯥꯔꯁꯤꯡꯅꯥ
ইঞ্জিনিয়ারিং	ꯏꯟꯖꯤꯅꯤꯌꯥꯔꯤꯡ
ইঞ্জিনিয়ারিংগী	ꯏꯟꯖꯤꯅꯤꯌꯥꯔꯤꯡꯒꯤ
ইটালি	ꯏꯇꯥꯂꯤ
ইটালিগী	ꯏꯇꯥꯂꯤꯒꯤ
ইটালিদা	ꯏꯇꯥꯂꯤꯗꯥ
ইতা	ꯏꯇꯥ
ইতাও	ꯏꯇꯥꯎ
ইতাক	ꯏꯇꯥꯛ
ইতালিগী	ꯏꯇꯥꯂꯤꯒꯤ
ইতালিনা	ꯏꯇꯥꯂꯤꯅꯥ
ইতিং	ꯏꯇꯤꯡ
ইতিক	ꯏꯇꯤꯛ
ইতিক্কা	ꯏꯇꯤꯛꯀꯥ
ইতিক্কী	ꯏꯇꯤꯛꯀꯤ
ইতিহাস	ꯏꯇꯤꯍꯥꯁ
ইতিহাসকী	ꯏꯇꯤꯍꯥꯁꯀꯤ
ইতিহাসতা	ꯏꯇꯤꯍꯥꯁꯇꯥ
ইতিহাসিক	ꯏꯇꯤꯍꯥꯁꯤꯛ
ইতু	ꯏꯇꯨ
ইতৈ	ꯏꯇꯩ
ইথং	ꯏꯊꯪ
ইথক	ꯏꯊꯛ
ইথনিক	ꯏꯊꯅꯤꯛ
ইথন্তা	ꯏꯊꯟꯇꯥ
ইথা	ꯏꯊꯥ
ইথাই	ꯏꯊꯥꯏ
ইথিক্স	ꯏꯊꯤꯛꯁ
ইথিল	ꯏꯊꯤꯜ
ইথৎ	ꯏꯊꯠ
ইথৎতা	ꯏꯊꯠꯇꯥ
ইদ	ꯏꯗ
ইদা	ꯏꯗꯥ
ইদিসন	ꯏꯗꯤꯁꯟ
ইদুনা	ꯏꯗꯨꯅꯥ
ইদুল	ꯏꯗꯨꯜ
ইন	ꯏꯟ
ইনক	ꯏꯅꯛ
ইনকম	ꯏꯅꯀꯝ
ইনক্বারি	ꯏꯅꯀ꯭ꯋꯥꯔꯤ
ইনক্যুবেসন	ꯏꯅꯀ꯭ꯌꯨꯕꯦꯁꯟ
ইনক্লুজন	ꯏꯅꯛꯂꯨꯖꯟ
ইনক্লুসিব	ꯏꯅꯛꯂꯨꯁꯤꯕ
ইনক্লুসিভ	ꯏꯅꯛꯂꯨꯁꯤꯚ
ইনখাং	ꯏꯟꯈꯥꯡ
ইনখি	ꯏꯟꯈꯤ
ইনখিবা	ꯏꯟꯈꯤꯕꯥ
ইনখৎলক্লিবা	ꯏꯟꯈꯠꯂꯛꯂꯤꯕꯥ
ইনগদবনি	ꯏꯟꯒꯗꯕꯅꯤ
ইনগদবা	ꯏꯟꯒꯗꯕꯥ
ইনদবা	ꯏꯟꯗꯕꯥ
ইনদা	ꯏꯟꯗꯥ
ইনদুনা	ꯏꯟꯗꯨꯅꯥ
ইনপুই	ꯏꯟꯄꯨꯢ
ইনফম	ꯏꯟꯐꯝ
ইনফেক্সন	ꯏꯟꯐꯦꯛꯁꯟ
ইনফেক্সনগী	ꯏꯟꯐꯦꯛꯁꯟꯒꯤ
ইনফ্রষ্ট্রকচর	ꯏꯟꯐ꯭ꯔꯁꯇ꯭ꯔꯛꯆꯔ
ইনফ্রা	ꯏꯟꯐ꯭ꯔꯥ
ইনফ্রাষ্টকচর	ꯏꯟꯐ꯭ꯔꯥꯁꯇꯛꯆꯔ
ইনফ্রাষ্ট্রকচর	ꯏꯟꯐ꯭ꯔꯥꯁꯇ꯭ꯔꯛꯆꯔ
ইনফ্রাষ্ট্রকচরগী	ꯏꯟꯐ꯭ꯔꯥꯁꯇ꯭ꯔꯛꯆꯔꯒꯤ
ইনফ্রাষ্ট্রকচরদা	ꯏꯟꯐ꯭ꯔꯥꯁꯇ꯭ꯔꯛꯆꯔꯗꯥ
ইনফ্রাষ্ট্রকচরশিং	ꯏꯟꯐ꯭ꯔꯥꯁꯇ꯭ꯔꯛꯆꯔꯁꯤꯡ
ইনবগা	ꯏꯟꯕꯒꯥ
ইনবগী	ꯏꯟꯕꯒꯤ
ইনবা	ꯏꯟꯕꯥ
ইনবীয়ু	ꯏꯟꯕꯤꯌꯨ
ইনভাইট	ꯏꯟꯚꯥꯢꯇ
ইনভেষ্টিং	ꯏꯟꯚꯦꯁꯇꯤꯡ
ইনভেষ্টিগেটিং	ꯏꯟꯚꯦꯁꯇꯤꯒꯦꯇꯤꯡ
ইনভেষ্টিগেসন	ꯏꯟꯚꯦꯁꯇꯤꯒꯦꯁꯟ
ইনভেষ্টিগেসনগী	ꯏꯟꯚꯦꯁꯇꯤꯒꯦꯁꯟꯒꯤ
ইনর্জি	ꯏꯅꯔꯖꯤ
ইনশিনবগী	ꯏꯟꯁꯤꯟꯕꯒꯤ
ইনশিনবা	ꯏꯟꯁꯤꯟꯕꯥ
ইনা	ꯏꯅꯥ
ইনাই	ꯏꯅꯥꯏ
ইনাও	ꯏꯅꯥꯎ
ইনাওনা	ꯏꯅꯥꯎꯅꯥ
ইনাওশা	ꯏꯅꯥꯑꯣꯁꯥ
ইনাওশিংগী	ꯏꯅꯥꯎꯁꯤꯡꯒꯤ
ইনাওশিংদা	ꯏꯅꯥꯎꯁꯤꯡꯗꯥ
ইনাওশিংনা	ꯏꯅꯥꯎꯁꯤꯡꯅꯥ
ইনাক	ꯏꯅꯥꯛ
ইনাৎ	ꯏꯅꯥꯠ
ইনিসিয়েটিব	ꯏꯅꯤꯁꯤꯌꯦꯇꯤꯕ
ইনিসিয়েটিবকী	ꯏꯅꯤꯁꯤꯌꯦꯇꯤꯕꯀꯤ
ইনিসিয়েটিভ	ꯏꯅꯤꯁꯤꯌꯦꯇꯤꯚ
ইনীং	ꯏꯅꯤꯪ
ইন্টর	ꯏꯟꯇꯔ
ইন্টরটেনমেন্ট	ꯏꯟꯇꯔꯇꯦꯟꯃꯦꯟꯇ
ইন্টরনেল	ꯏꯟꯇꯔꯅꯦꯜ
ইন্টরনেসনেল	ꯏꯟꯇꯔꯅꯦꯁꯅꯦꯜ
ইন্টরপ্রাইজেস	ꯏꯟꯇꯔꯄ꯭ꯔꯥꯢꯖꯦꯁ
ইন্টরফেস	ꯏꯟꯇꯔꯐꯦꯁ
ইন্টরভিয়ু	ꯏꯟꯇꯔꯚꯤꯌꯨ
ইন্টরিম	ꯏꯟꯇꯔꯤꯝ
ইন্টরিয়র	ꯏꯟꯇꯔꯤꯌꯔ
ইন্টরেক্সন	ꯏꯟꯇꯔꯦꯛꯁꯟ
ইন্টরেষ্ট	ꯏꯟꯇꯔꯦꯁꯇ
ইন্টর্নেসনেল	ꯏꯟꯇꯔꯅꯦꯁꯅꯦꯂ
ইন্টিগ্রেটেদ	ꯏꯟꯇꯤꯒ꯭ꯔꯦꯇꯦꯗ
ইন্তরনেল	ꯏꯟꯇꯔꯅꯦꯜ
ইন্থুরগা	ꯏꯟꯊꯨꯔꯒꯥ
ইন্দবা	ꯏꯟꯗꯕꯥ
ইন্দষ্ট্রি	ꯏꯟꯗꯁꯇ꯭ꯔꯤ
ইন্দষ্ট্রিগী	ꯏꯟꯗꯁꯇ꯭ꯔꯤꯒꯤ
ইন্দষ্ট্রিজ	ꯏꯟꯗꯁꯇ꯭ꯔꯤꯖ
ইন্দষ্ট্রিশিং	ꯏꯟꯗꯁꯇ꯭ꯔꯤꯁꯤꯡ
ইন্দষ্ট্রিশিংদা	ꯏꯟꯗꯁꯇ꯭ꯔꯤꯁꯤꯡꯗꯥ
ইন্দষ্ট্রিয়েল	ꯏꯟꯗꯁꯇ꯭ꯔꯤꯌꯦꯜ
ইন্দিজিনস	ꯏꯟꯗꯤꯖꯤꯅꯁ
ইন্দিপেন্দেন্ট	ꯏꯟꯗꯤꯄꯦꯟꯗꯦꯟꯇ
ইন্দিপেন্দেন্স	ꯏꯟꯗꯤꯄꯦꯟꯗꯦꯟꯁ
ইন্দিভিজুয়েল	ꯏꯟꯗꯤꯚꯤꯖꯨꯌꯦꯜ
ইন্দিরা	ꯏꯟꯗꯤꯔꯥ
ইন্দিরাগী	ꯏꯟꯗꯤꯔꯥꯒꯤ
ইন্দিয়ন	ꯏꯟꯗꯤꯌꯅ
ইন্দিয়া	ꯏꯟꯗꯤꯌꯥ
ইন্দিয়াগা	ꯏꯟꯗꯤꯌꯥꯒꯥ
ইন্দিয়াগী	ꯏꯟꯗꯤꯌꯥꯒꯤ
ইন্দিয়াদগী	ꯏꯟꯗꯤꯌꯥꯗꯒꯤ
ইন্দিয়াদসু	ꯏꯟꯗꯤꯌꯥꯗꯁꯨ
ইন্দিয়াদা	ꯏꯟꯗꯤꯌꯥꯗꯥ
ইন্দিয়ান	ꯏꯟꯗꯤꯌꯥꯅ
ইন্দিয়ানসু	ꯏꯟꯗꯤꯌꯥꯟꯁꯨ
ইন্দিয়ানা	ꯏꯟꯗꯤꯌꯥꯅꯥ
ইন্দিয়াবু	ꯏꯟꯗꯤꯌꯥꯕꯨ
ইন্দিয়াসু	ꯏꯟꯗꯤꯌꯥꯁꯨ
ইন্দুনা	ꯏꯟꯗꯨꯅꯥ
ইন্দেক্স	ꯏꯟꯗꯦꯛꯁ
ইন্দ্রজিৎ	ꯏꯟꯗ꯭ꯔꯖꯤꯠ
ইন্নখি	ꯏꯟꯅꯈꯤ
ইন্নদুনা	ꯏꯟꯅꯗꯨꯅꯥ
ইন্ননা	ꯏꯟꯅꯅꯥ
ইন্ননি	ꯏꯟꯅꯅꯤ
ইন্নবসু	ꯏꯟꯅꯕꯁꯨ
ইন্নবা	ꯏꯟꯅꯕꯥ
ইন্নর	ꯏꯟꯅꯔ
ইন্নরি	ꯏꯟꯅꯔꯤ
ইন্না	ꯏꯟꯅꯥ
ইন্নৈ	ꯏꯟꯅꯩ
ইন্সটিট্যুট	ꯏꯟꯁꯇꯤꯇ꯭ꯌꯨꯠ
ইন্সটিট্যুটকী	ꯏꯟꯁꯇꯤꯇ꯭ꯌꯨꯠꯀꯤ
ইন্সটিট্যুটনা	ꯏꯟꯁꯇꯤꯇ꯭ꯌꯨꯠꯅꯥ
ইন্সটিট্যুটশিং	ꯏꯟꯁꯇꯤꯇ꯭ꯌꯨꯠꯁꯤꯡ
ইন্সটিট্যুসন	ꯏꯟꯁꯇꯤꯇ꯭ꯌꯨꯁꯟ
ইন্সটিট্যুসনশিং	ꯏꯟꯁꯇꯤꯇ꯭ꯌꯨꯁꯟꯁꯤꯡ
ইন্সটিট্যুসনশিংদা	ꯏꯟꯁꯇꯤꯇ꯭ꯌꯨꯁꯟꯁꯤꯡꯗꯥ
ইন্সটিট্যুসনশিংনা	ꯏꯟꯁꯇꯤꯇ꯭ꯌꯨꯁꯟꯁꯤꯡꯅꯥ
ইন্সটিট্যুসনেল	ꯏꯟꯁꯇꯤꯇ꯭ꯌꯨꯁꯅꯦꯜ
ইন্সট্রক্সন	ꯏꯟꯁꯇ꯭ꯔꯛꯁꯟ
ইন্সপেক্টর	ꯏꯟꯁꯄꯦꯛꯇꯔ
ইন্সরজেন্সি	ꯏꯟꯁꯔꯖꯦꯟꯁꯤ
ইন্সরজেন্সিগী	ꯏꯟꯁꯔꯖꯦꯟꯁꯤꯒꯤ
ইন্সাং	ꯏꯟꯁꯥꯡ
ইন্সুরেন্স	ꯏꯟꯁꯨꯔꯦꯟꯁ
ইন্সুরেন্সকী	ꯏꯟꯁꯨꯔꯦꯟꯁꯀꯤ
ইন্সেন্টিব	ꯏꯟꯁꯦꯟꯇꯤꯕ
ইপা	ꯏꯄꯥ
ইপাই	ꯏꯄꯥꯏ
ইপাক	ꯏꯄꯥꯛ
ইপাগী	ꯏꯄꯥꯒꯤ
ইপাদি	ꯏꯄꯥꯗꯤ
ইপানা	ꯏꯄꯥꯅꯥ
ইপাবু	ꯏꯄꯥꯕꯨ
ইপিক	ꯏꯄꯤꯛ
ইপিদেমিক	ꯏꯄꯤꯗꯦꯃꯤꯛ
ইপিসেন্টর	ꯏꯄꯤꯁꯦꯟꯇꯔ
ইপু	ꯏꯄꯨ
ইপুগী	ꯏꯄꯨꯒꯤ
ইপুনা	ꯏꯄꯨꯅꯥ
ইপুশিংগী	ꯏꯄꯨꯁꯤꯡꯒꯤ
ইপুশিংনা	ꯏꯄꯨꯁꯤꯡꯅꯥ
ইফ	ꯏꯐ
ইফেক্ট	ꯏꯐꯦꯛꯇ
ইবগী	ꯏꯕꯒꯤ
ইবনি	ꯏꯕꯅꯤ
ইবা	ꯏꯕꯥ
ইবানি	ꯏꯕꯥꯅꯤ
ইবুং	ꯏꯕꯨꯪ
ইবেন	ꯏꯕꯦꯅ
ইবেম্মগী	ꯏꯕꯦꯝꯃꯒꯤ
ইবেম্মনা	ꯏꯕꯦꯝꯃꯅꯥ
ইবেম্মা	ꯏꯕꯦꯝꯃꯥ
ইবেল	ꯏꯕꯦꯜ
ইব্রাহিম	ꯏꯕꯔꯥꯍꯤꯝ
ইব্রাহিমনা	ꯏꯕꯔꯥꯍꯤꯝꯅꯥ
ইভিদেন্স	ꯏꯚꯤꯗꯦꯟꯁ
ইভেন্ট	ꯏꯚꯦꯟꯇ
ইমপেক্ট	ꯏꯝꯄꯦꯛꯇ
ইমরান	ꯏꯝꯔꯥꯟ
ইমরেটসকী	ꯏꯝꯔꯦꯇꯁꯀꯤ
ইমর্জেন্সি	ꯏꯃꯔꯖꯦꯟꯁꯤ
ইমর্জেন্সিগী	ꯏꯃꯔꯖꯦꯟꯁꯤꯒꯤ
ইমা	ꯏꯃꯥ
ইমাক	ꯏꯃꯥꯀ
ইমাগী	ꯏꯃꯥꯒꯤ
ইমাদি	ꯏꯃꯥꯗꯤ
ইমানা	ꯏꯃꯥꯅꯥ
ইমান্নবা	ꯏꯃꯥꯟꯅꯕꯥ
ইমাবু	ꯏꯃꯥꯕꯨ
ইমার্জেন্সি	ꯏꯃꯥꯔꯖꯦꯟꯁꯤ
ইমাশিং	ꯏꯃꯥꯁꯤꯡ
ইমাশিংবু	ꯏꯃꯥꯁꯤꯡꯕꯨ
ইমাসি	ꯏꯃꯥꯁꯤ
ইমায়	ꯏꯃꯥꯌ
ইমায়সু	ꯏꯃꯥꯌꯁꯨ
ইমিসন	ꯏꯃꯤꯁꯟ
ইমুং	ꯏꯃꯨꯡ
ইমুংগী	ꯏꯃꯨꯡꯒꯤ
ইমুংদগী	ꯏꯃꯨꯪꯗꯒꯤ
ইমুংদা	ꯏꯃꯨꯡꯗꯥ
ইমুংদু	ꯏꯃꯨꯪꯗꯨ
ইমুংদুগী	ꯏꯃꯨꯪꯗꯨꯒꯤ
ইমুংদুদা	ꯏꯃꯨꯪꯗꯨꯗꯥ
ইমুংশিং	ꯏꯃꯨꯡꯁꯤꯡ
ইমুংশিংগী	ꯏꯃꯨꯡꯁꯤꯡꯒꯤ
ইমুংশিংদা	ꯏꯃꯨꯡꯁꯤꯡꯗꯥ
ইমুংশিংনা	ꯏꯃꯨꯡꯁꯤꯡꯅꯥ
ইমুংশিংসু	ꯏꯃꯨꯡꯁꯤꯡꯁꯨ
ইমুংসিগী	ꯏꯃꯨꯪꯁꯤꯒꯤ
ইম্পেক্ট	ꯏꯝꯄꯦꯛꯇ
ইম্পৱার	ꯏꯝꯄ꯭ꯋꯥꯔ
ইম্পৱারমেন্ট	ꯏꯝꯄ꯭ꯋꯥꯔꯃꯦꯟꯇ
ইম্পৱারমেন্টকী	ꯏꯝꯄ꯭ꯋꯥꯔꯃꯦꯟꯇꯀꯤ
ইম্ফাল	ꯏꯝꯐꯥꯜ
ইম্ফালগা	ꯏꯝꯐꯥꯜꯒꯥ
ইম্ফালগী	ꯏꯝꯐꯥꯜꯒꯤ
ইম্ফালদগী	ꯏꯝꯐꯥꯜꯗꯒꯤ
ইম্ফালদা	ꯏꯝꯐꯥꯜꯗꯥ
ইম্ফালনসু	ꯏꯝꯐꯥꯜꯅꯁꯨ
ইম্ফালনা	ꯏꯝꯐꯥꯜꯅꯥ
ইম্ফালসু	ꯏꯝꯐꯥꯜꯁꯨ
ইম্মরজেন্সি	ꯏꯝꯃꯔꯖꯦꯟꯁꯤ
ইরং	ꯏꯔꯪ
ইরংদা	ꯏꯔꯪꯗꯥ
ইরকপা	ꯏꯔꯛꯄꯥ
ইরমখি	ꯏꯔꯝꯈꯤ
ইরমদম	ꯏꯔꯝꯗꯝ
ইরমদমগী	ꯏꯔꯝꯗꯝꯒꯤ
ইরম্বতা	ꯏꯔꯝꯕꯇꯥ
ইরম্বা	ꯏꯔꯝꯕꯥ
ইরম্মী	ꯏꯔꯝꯃꯤ
ইরম্লে	ꯏꯔꯝꯂꯦ
ইরা	ꯏꯔꯥ
ইরাং	ꯏꯔꯥꯡ
ইরাংদা	ꯏꯔꯥꯡꯗꯥ
ইরাংনা	ꯏꯔꯥꯡꯅꯥ
ইরাই	ꯏꯔꯥꯢ
ইরান	ꯏꯔꯥꯟ
ইরানদা	ꯏꯔꯥꯟꯗꯥ
ইরাবত	ꯏꯔꯥꯕꯠ
ইরাবতকী	ꯏꯔꯥꯕꯠꯀꯤ
ইরাবতনা	ꯏꯔꯥꯕꯠꯅꯥ
ইরাল	ꯏꯔꯥꯜ
ইরাৎ	ꯏꯔꯥꯠ
ইরায়	ꯏꯔꯥꯌ
ইরি	ꯏꯔꯤ
ইরিবা	ꯏꯔꯤꯕꯥ
ইরিল	ꯏꯔꯤꯜ
ইরুংবম	ꯏꯔꯨꯡꯕꯝ
ইরেংবম	ꯏꯔꯦꯡꯕꯝ
ইরেংবমনা	ꯏꯔꯦꯡꯕꯝꯅꯥ
ইরেপ	ꯏꯔꯦꯄ
ইরৈবাক	ꯏꯔꯩꯕꯥꯛ
ইল	ꯏꯜ
ইলহন্নবা	ꯏꯜꯍꯟꯅꯕꯥ
ইলিজিবল	ꯏꯂꯤꯖꯤꯕꯜ
ইলেক্সন	ꯏꯂꯦꯛꯁꯟ
ইলেক্সনগী	ꯏꯂꯦꯛꯁꯟꯒꯤ
ইলেক্সনদা	ꯏꯂꯦꯛꯁꯟꯗꯥ
ইলেক্সসন	ꯏꯂꯦꯛꯁꯟ
ইল্লদুনা	ꯏꯜꯂꯗꯨꯅꯥ
ইল্লবদি	ꯏꯜꯂꯕꯗꯤ
ইল্লে	ꯏꯜꯂꯦ
ইশম	ꯏꯁꯝ
ইশা	ꯏꯁꯥ
ইশাগী	ꯏꯁꯥꯒꯤ
ইশাদা	ꯏꯁꯥꯗꯥ
ইশানা	ꯏꯁꯥꯅꯥ
ইশাবু	ꯏꯁꯥꯕꯨ
ইশাসু	ꯏꯁꯥꯁꯨ
ইশিং	ꯏꯁꯤꯡ
ইশু	ꯏꯁꯨ
ইশ্বরগী	ꯏꯁꯋ꯭ꯔꯒꯤ
ইষ্ট	ꯏꯁꯇ
ইষ্টকী	ꯏꯁꯇ꯭ꯀꯤ
ইষ্টতগী	ꯏꯁꯇꯒꯤ
ইষ্টতগীনি	ꯏꯁꯇꯒꯤꯅꯤ
ইষ্টতা	ꯏꯁꯇꯥ
ইষ্টনা	ꯏꯁꯇꯅꯥ
ইষ্টর্ন	ꯏꯁꯇ꯭ꯔꯟ
ইষ্টাব্লিসমেন্ট	ꯏꯁꯇꯥꯕ꯭ꯂꯤꯁꯃꯦꯟꯇ
ইষ্টাব্লিসমেন্টশিং	ꯏꯁꯇ꯭ꯥꯕꯂꯤꯁꯃꯦꯟꯇꯁꯤꯪ
ইষ্টিমেট	ꯏꯁꯇꯤꯃꯦꯠ
ইষ্টেট	ꯏꯁ꯭ꯇꯦꯠ
ইস	ꯏꯁ
ইসাক	ꯏꯁꯥꯀ
ইসু	ꯏꯁꯨ
ইসুগী	ꯏꯁꯨꯒꯤ
ইসুশিং	ꯏꯁꯨꯁꯤꯡ
ইসুশিংগী	ꯏꯁꯨꯁꯤꯡꯒꯤ
ইসেন্সিয়েল	ꯏꯁꯦꯟꯁꯤꯌꯦꯜ
ইস্লাম	ꯏꯁꯂꯥꯝ
ইস্লামগী	ꯏꯁꯂꯥꯝꯒꯤ
ইস্লামিক	ꯏꯁꯂꯥꯃꯤꯛ
ইহাং	ꯏꯍꯥꯡ
ইহান	ꯏꯍꯥꯟ
ইহুল	ꯏꯍꯨꯜ
ইৎলবা	ꯏꯠꯂꯕꯥ
ইয়া	ꯏꯌꯥ
ইয়াও	ꯏꯌꯥꯎ
ইয়াম্বগী	ꯏꯌꯥꯝꯕꯒꯤ
ইয়াম্বা	ꯏꯌꯥꯝꯕꯥ
ইয়ার	ꯏꯌꯥꯔ
ইয়ু	ꯏꯌꯨ
ইয়ুম	ꯏꯌꯨꯃ
ইয়েক	ꯏꯌꯦꯛ
ঈ	ꯏ
ঈংনা	ꯏꯪꯅꯥ
ঈগী	ꯏꯒꯤ
ঈচাও	ꯏꯆꯥꯎ
ঈচেল	ꯏꯆꯦꯜ
ঈচেলদা	ꯏꯆꯦꯜꯗꯥ
ঈজৎ	ꯏꯖꯠ
ঈতিক	ꯏꯇꯤꯛ
ঈতিক্কী	ꯏꯇꯤꯛꯀꯤ
ঈথিল	ꯏꯊꯤꯜ
ঈথৎকী	ꯏꯊꯠꯀꯤ
ঈথৎতা	ꯏꯊꯠꯇꯥ
ঈনা	ꯏꯅꯥ
ঈপাক	ꯏꯄꯥꯛ
ঈমায়	ꯏꯃꯥꯌ
ঈরা	ꯏꯔꯥ
ঈরু	ꯏꯔꯨ
ঈরুজবা	ꯏꯔꯨꯖꯕꯥ
ঈরুজরগা	ꯏꯔꯨꯖꯔꯒꯥ
ঈরৈদা	ꯏꯔꯩꯗꯥ
ঈশিং	ꯏꯁꯤꯡ
ঈশিংগী	ꯏꯁꯤꯡꯒꯤ
ঈশিংদগী	ꯏꯁꯤꯡꯗꯒꯤ
ঈশিংদা	ꯏꯁꯤꯡꯗꯥ
ঈশিংদু	ꯏꯁꯤꯪꯗꯨ
ঈশিংনা	ꯏꯁꯤꯡꯅꯥ
ঈশৈ	ꯏꯁꯩ
ঈশৈগা	ꯏꯁꯩꯒꯥ
ঈশৈগী	ꯏꯁꯩꯒꯤ
ঈশৈদা	ꯏꯁꯩꯗꯥ
ঈশৈদি	ꯏꯁꯩꯗꯤ
ঈশৈবু	ꯏꯁꯩꯕꯨ
ঈশৈশিং	ꯏꯁꯩꯁꯤꯡ
ঈশৈশিংদা	ꯏꯁꯩꯁꯤꯡꯗꯥ
ঈশৈসু	ꯏꯁꯩꯁꯨ
ঈশ্বর	ꯏꯁꯋ꯭ꯔ
ঈশ্বরগী	ꯏꯁꯋ꯭ꯔꯒꯤ
ঈশ্বরদা	ꯏꯁꯋ꯭ꯔꯗꯥ
ঈশ্বরনা	ꯏꯁꯋ꯭ꯔꯅꯥ
ঈশ্বরবু	ꯏꯁꯋ꯭ꯔꯕꯨ
ঊ	ꯎ
ঊগী	ꯎꯒꯤ
ঊমং	ꯎꯃꯪ
এ	ꯑꯦ
এআরগী	ꯑꯦꯑꯥꯔꯒꯤ
এইদ	ꯑꯦꯢꯗ
এইদস	ꯑꯦꯢꯗꯁ
এইদসকী	ꯑꯦꯢꯗꯁꯀꯤ
এইমস	ꯑꯦꯏꯝꯁ
এইমসকী	ꯑꯦꯏꯝꯁꯀꯤ
এইমসতা	ꯑꯦꯏꯝꯁꯇꯥ
একজাম	ꯑꯦꯀꯖꯥꯃ
একজামগী	ꯑꯦꯛꯖꯥꯝꯒꯤ
একজিবিসন	ꯑꯦꯛꯖꯤꯕꯤꯁꯟ
একতা	ꯑꯦꯛꯇꯥ
একর	ꯑꯦꯀꯔ
একাদমি	ꯑꯦꯀꯥꯗꯃꯤ
একাদমিক	ꯑꯦꯀꯥꯗꯃꯤꯛ
একাদমিগী	ꯑꯦꯀꯥꯗꯃꯤꯒꯤ
একাদমিদা	ꯑꯦꯀꯥꯗꯃꯤꯗꯥ
একাদমিনা	ꯑꯦꯀꯥꯗꯃꯤꯅꯥ
একাদমী	ꯑꯦꯀꯥꯗꯃꯤ
একাদেমি	ꯑꯦꯀꯥꯗꯦꯃꯤ
একাদেমিক	ꯑꯦꯀꯥꯗꯦꯃꯤꯛ
একাদেমীক	ꯑꯦꯀꯥꯗꯦꯃꯤꯛ
এক্ট	ꯑꯦꯛꯇ
এক্টকী	ꯑꯦꯛꯇꯀꯤ
এক্টনচিংবা	ꯑꯦꯛꯇꯅꯆꯤꯡꯕꯥ
এক্টপু	ꯑꯦꯛꯇꯄꯨ
এক্টর	ꯑꯦꯛꯇꯔ
এক্টশিং	ꯑꯦꯛꯇꯁꯤꯡ
এক্টশিংগী	ꯑꯦꯛꯇꯁꯤꯡꯒꯤ
এক্টিং	ꯑꯦꯛꯇꯤꯡ
এক্ট্রেস	ꯑꯦꯛꯇ꯭ꯔꯦꯁ
এক্বাটিক	ꯑꯦꯀ꯭ꯋꯥꯇꯤꯛ
এক্যুট	ꯑꯦꯀ꯭ꯌꯨꯇ
এক্স	ꯑꯦꯛꯁ
এক্সক্লুসিব	ꯑꯦꯛꯁꯀ꯭ꯂꯨꯁꯤꯕ
এক্সটেন্সন	ꯑꯦꯛꯁꯇꯦꯟꯁꯟ
এক্সট্রিমিষ্ট	ꯑꯦꯀꯁ꯭ꯠꯔꯤꯃꯤꯁꯇ꯭
এক্সতর্নেল	ꯑꯦꯛꯁꯇꯔꯅꯦꯜ
এক্সন	ꯑꯦꯛꯁꯟ
এক্সপরিমেন্ট	ꯑꯦꯛꯁꯄꯔꯤꯃꯦꯟꯇ
এক্সপরিয়েন্স	ꯑꯦꯛꯁꯄꯔꯤꯌꯦꯟꯁ
এক্সপর্টশিংনা	ꯑꯦꯛꯁꯄꯔꯠꯁꯤꯡꯅꯥ
এক্সপান্সন	ꯑꯦꯛꯁꯄꯥꯟꯁꯟ
এক্সপার্ট	ꯑꯦꯛꯁꯄꯥꯔꯇ
এক্সপার্টশিংগা	ꯑꯦꯛꯁꯄꯥꯔꯇꯁꯤꯡꯒꯥ
এক্সপার্টশিংগী	ꯑꯦꯛꯁꯄꯥꯔꯇꯁꯤꯡꯒꯤ
এক্সপার্টশিংনা	ꯑꯦꯛꯁꯄꯥꯔꯇꯁꯤꯡꯅꯥ
এক্সপিদিসন	ꯑꯦꯛꯁꯄꯤꯗꯤꯁꯟ
এক্সপ্রেস	ꯑꯦꯛꯁꯄ꯭ꯔꯦꯁ
এক্সপ্রেসকী	ꯑꯦꯛꯁꯄ꯭ꯔꯦꯁꯀꯤ
এক্সপ্রেসতা	ꯑꯦꯛꯁꯄ꯭ꯔꯦꯁꯇꯥ
এক্সপ্রেসন	ꯑꯦꯛꯁꯄ꯭ꯔꯦꯁꯟ
এক্সপ্রেসনা	ꯑꯦꯛꯁꯄ꯭ꯔꯦꯁꯅꯥ
এক্সরসাইজ	ꯑꯦꯛꯁ꯭ꯔꯁꯥꯏꯖ
এক্সাইজ	ꯑꯦꯛꯁꯥEꯖ
এক্সিদেন্ট	ꯑꯦꯛꯁꯤꯗꯦꯟꯇ
এক্সিদেন্টতা	ꯑꯦꯛꯁꯤꯗꯦꯟꯇꯇꯥ
এগজাম	ꯑꯦꯒꯖꯥꯝ
এগজামশিং	ꯑꯦꯒꯖꯥꯝꯁꯤꯡ
এগী	ꯑꯦꯒꯤ
এগেনষ্ট	ꯑꯦꯒꯦꯟꯁꯇ
এগ্রি	ꯑꯦꯒꯔꯤ
এগ্রিকলচর	ꯑꯦꯒꯔꯤꯀꯜꯆꯔ
এগ্রিকলচরেল	ꯑꯦꯒꯔꯤꯀꯜꯆꯔꯦꯜ
এগ্রিমেন্ট	ꯑꯦꯒꯔꯤꯃꯦꯟꯇ
এগ্রিমেন্টতা	ꯑꯦꯒꯔꯤꯃꯦꯟꯇꯇꯥ
এগ্রীকলচর	ꯑꯦꯒꯔꯤꯀꯜꯆꯔ
এঙ্করনা	ꯑꯦꯡꯀꯔꯅꯥ
এচিবমেন্ট	ꯑꯦꯆꯤꯕꯃꯦꯟꯇ
এচিভমেন্ট	ꯑꯦꯆꯤꯚꯃꯦꯟꯇ
এজ	ꯑꯦꯖ
এজেন্ট	ꯑꯦꯖꯦꯟꯇ
এজেন্দাদা	ꯑꯦꯖꯦꯟꯗꯥꯗꯥ
এজেন্সি	ꯑꯦꯖꯦꯟꯁꯤ
এজেন্সিগী	ꯑꯦꯖꯦꯟꯁꯤꯒꯤ
এজেন্সিদা	ꯑꯦꯖꯦꯟꯁꯤꯗꯥ
এজেন্সিনা	ꯑꯦꯖꯦꯟꯁꯤꯅꯥ
এজেন্সিশিং	ꯑꯦꯖꯦꯟꯁꯤꯁꯤꯡ
এজেন্সিশিংদা	ꯑꯦꯖꯦꯟꯁꯤꯁꯤꯡꯗꯥ
এজেন্সিশিংনা	ꯑꯦꯖꯦꯟꯁꯤꯁꯤꯡꯅꯥ
এঞ্ছাং	ꯑꯦꯟꯁꯥꯡ
এঞ্জাং	ꯑꯦꯟꯖꯥꯡ
এঞ্জেলা	ꯑꯦꯟꯖꯦꯂꯥ
এট	ꯑꯦꯇ
এটেক	ꯑꯦꯇꯦꯛ
এটেন্সন	ꯑꯦꯇꯦꯟꯁꯟ
এট্টেক	ꯑꯦꯠꯇꯦꯛ
এঠলেট	ꯑꯦꯊꯂꯦꯠ
এঠলেটশিং	ꯑꯦꯊꯂꯦꯇꯁꯤꯡ
এঠলেটিক	ꯑꯦꯊꯂꯦꯇꯤꯛ
এঠলেটিক্স	ꯑꯦꯊꯂꯦꯇꯤꯛꯁ
এডিসনেল	ꯑꯦꯗꯤꯁꯅꯦꯂ
এণ্ড	ꯑꯦꯟꯗ
এদ	ꯑꯦꯗ
এদভর্টিসমেন্ট	ꯑꯦꯗꯚꯔꯇꯤꯁꯃꯦꯟꯇ
এদভর্স	ꯑꯦꯗꯚꯔꯁ
এদভাইজর	ꯑꯦꯗꯚꯥꯏꯖꯔ
এদভাইজরি	ꯑꯦꯗꯚꯥꯏꯖꯔꯤ
এদভাইস	ꯑꯦꯗꯚꯥꯏꯁ
এদভান্স	ꯑꯦꯗꯚꯥꯟꯁ
এদমিট	ꯑꯦꯗꯃꯤꯠ
এদমিনিষ্ট্রেটর	ꯑꯦꯗꯃꯤꯅꯤꯁꯇ꯭ꯔꯦꯇꯔ
এদমিনিষ্ট্রেটিব	ꯑꯦꯗꯃꯤꯅꯤꯁꯇ꯭ꯔꯦꯇꯤꯕ
এদমিনিষ্ট্রেসন	ꯑꯦꯗꯃꯤꯅꯤꯁꯇ꯭ꯔꯦꯁꯟ
এদমিনিষ্ট্রেসনগা	ꯑꯦꯗꯃꯤꯅꯤꯁꯇ꯭ꯔꯦꯁꯟꯒꯥ
এদমিনিষ্ট্রেসনগী	ꯑꯦꯗꯃꯤꯅꯤꯁꯇ꯭ꯔꯦꯁꯟꯒꯤ
এদমিনিষ্ট্রেসনদা	ꯑꯦꯗꯃꯤꯅꯤꯁꯇ꯭ꯔꯦꯁꯟꯗꯥ
এদমিনিষ্ট্রেসননা	ꯑꯦꯗꯃꯤꯅꯤꯁꯇ꯭ꯔꯦꯁꯟꯅꯥ
এদমিনিষ্ট্রেসনশিংনা	ꯑꯦꯗꯃꯤꯅꯤꯁꯇ꯭ꯔꯦꯁꯟꯁꯤꯡꯅꯥ
এদমিনিষ্ট্রেসন্নসু	ꯑꯦꯗꯃꯤꯅꯤꯁꯇ꯭ꯔꯦꯁꯟꯅꯁꯨ
এদমিনিষ্ট্রেসন্না	ꯑꯦꯗꯃꯤꯅꯤꯁꯇ꯭ꯔꯦꯁꯟꯅꯥ
এদমিসন	ꯑꯦꯗꯃꯤꯁꯟ
এদমিসনগী	ꯑꯦꯗꯃꯤꯁꯟꯒꯤ
এদিটর	ꯑꯦꯗꯤꯇꯔ
এদিটরশিংগী	ꯑꯦꯗꯤꯇꯔꯁꯤꯡꯒꯤ
এদিসনদা	ꯑꯦꯗꯤꯁꯟꯗꯥ
এদিসনেল	ꯑꯦꯗꯤꯁꯅꯦꯜ
এদিসি	ꯑꯦꯗꯤꯁꯤ
এদিস্নেল	ꯑꯦꯗꯤꯁꯅꯦꯂ
এদুকেটরশিং	ꯑꯦꯗꯨꯀꯦꯇꯔꯁꯤꯡ
এদুকেসন	ꯑꯦꯗꯨꯀꯦꯁꯟ
এদুকেসনগা	ꯑꯦꯗꯨꯀꯦꯁꯟꯒꯥ
এদুকেসনগী	ꯑꯦꯗꯨꯀꯦꯁꯟꯒꯤ
এদুকেসননা	ꯑꯦꯗꯨꯀꯦꯁꯟꯅꯥ
এদুকেসনেল	ꯑꯦꯗꯨꯀꯦꯁꯅꯦꯜ
এদেদ	ꯑꯦꯗꯦꯗ
এদ্রেস	ꯑꯦꯗꯔꯦꯁ
এন	ꯑꯦꯟ
এনগী	ꯑꯦꯟꯒꯤ
এনজি	ꯑꯦꯅꯖꯤ
এননা	ꯑꯦꯟꯅꯥ
এনা	ꯑꯦꯅꯥ
এনিমেল	ꯑꯦꯅꯤꯃꯦꯜ
এন্টি	ꯑꯦꯟꯇꯤ
এন্টিজেন	ꯑꯦꯟꯇꯤꯖꯦꯟ
এন্দ	ꯑꯦꯟꯗ
এন্দ্রি	ꯑꯦꯟꯗꯔꯤ
এপ	ꯑꯦꯞ
এপেক্স	ꯑꯦꯄꯦꯛꯁ
এপ্রিল	ꯑꯦꯞꯔꯤꯜ
এপ্রিলগী	ꯑꯦꯞꯔꯤꯜꯒꯤ
এপ্রিলদগী	ꯑꯦꯞꯔꯤꯜꯗꯒꯤ
এপ্রিসিয়েট	ꯑꯦꯄꯔꯤꯁꯤꯌꯦꯇ
এপ্রিসিয়েসন	ꯑꯦꯄꯔꯤꯁꯤꯌꯦꯁꯟ
এপ্রুভ	ꯑꯦꯄꯔꯨꯚ
এপ্লাই	ꯑꯦꯞꯂꯥꯏ
এপ্লিকেসন	ꯑꯦꯞꯂꯤꯀꯦꯁꯟ
এপ্লিকেসনশিং	ꯑꯦꯞꯂꯤꯀꯦꯁꯟꯁꯤꯡ
এফ	ꯑꯦꯐ
এফিদেবিট	ꯑꯦꯐꯤꯗꯦꯕꯤꯠ
এফিলিয়েট	ꯑꯦꯐꯤꯂꯤꯌꯦꯠ
এফিয়ারস	ꯑꯦꯐꯤꯌꯥꯔꯁ
এফিয়ার্স	ꯑꯦꯐꯤꯌꯥꯔꯁ
এফিয়ার্সকী	ꯑꯦꯐꯤꯌꯥꯔꯁꯀꯤ
এফিয়ার্সতা	ꯑꯦꯐꯤꯌꯥꯔꯁꯇꯥ
এফিয়ার্সনা	ꯑꯦꯐꯤꯌꯥꯔꯁꯅꯥ
এফিয়াস	ꯑꯦꯐꯤꯌꯥꯁ
এবু	ꯑꯦꯕꯨ
এভরেজ	ꯑꯦꯚꯔꯦꯖ
এভরেষ্ট	ꯑꯦꯚꯔꯦꯁꯇ
এভিয়েসন	ꯑꯦꯚꯤꯌꯦꯁꯟ
এভিয়েসনগী	ꯑꯦꯚꯤꯌꯦꯁꯟꯒꯤ
এম	ꯑꯦꯝ
এমএলএ	ꯑꯦꯃꯑꯦꯂꯑꯦ
এমগা	ꯑꯦꯝꯒꯥ
এমগী	ꯑꯦꯝꯒꯤ
এমনা	ꯑꯦꯝꯅꯥ
এমসু	ꯑꯦꯝꯁꯨ
এমসুগী	ꯑꯦꯝꯁꯨꯒꯤ
এমসুনা	ꯑꯦꯝꯁꯨꯅꯥ
এমসুবু	ꯑꯦꯃꯁꯨꯕꯨ
এমেনমেন্ট	ꯑꯦꯃꯦꯟꯃꯦꯟꯠ
এমেন্দ	ꯑꯦꯃꯦꯟꯗ
এমেন্দমেন্ট	ꯑꯦꯃꯦꯟꯗꯃꯦꯟꯠ
এম্বুলেন্স	ꯑꯦꯝꯕꯨꯂꯦꯟꯁ
এম্বুলেন্সশিং	ꯑꯦꯝꯕꯨꯂꯦꯟꯁꯁꯤꯡ
এরিয়া	ꯑꯦꯔꯤꯌꯥ
এরিয়াগী	ꯑꯦꯔꯤꯌꯥꯒꯤ
এরিয়াজ	ꯑꯦꯔꯤꯌꯥꯖ
এরিয়াদগী	ꯑꯦꯔꯤꯌꯥꯗꯒꯤ
এরিয়াদা	ꯑꯦꯔꯤꯌꯥꯗꯥ
এরিয়ানি	ꯑꯦꯔꯤꯌꯥꯅꯤ
এরিয়াশিং	ꯑꯦꯔꯤꯌꯥꯁꯤꯡ
এরিয়াশিংদা	ꯑꯦꯔꯤꯌꯥꯁꯤꯡꯗꯥ
এরিয়েল	ꯑꯦꯔꯤꯌꯦꯜ
এরেঞ্জমেন্ট	ꯑꯦꯔꯦꯟꯖꯃꯦꯟꯇ
এরেষ্ট	ꯑꯦꯔꯦꯁꯇ꯭
এল	ꯑꯦꯜ
এলনা	ꯑꯦꯜꯅꯥ
এলাংবম	ꯑꯦꯂꯥꯡꯕꯝ
এলাংবমনা	ꯑꯦꯂꯥꯡꯕꯝꯅꯥ
এলার্ট	ꯑꯦꯂꯥꯔꯠ
এলেবেন	ꯑꯦꯂꯦꯕꯦꯟ
এল্লাইদ	ꯑꯦꯜꯂꯥꯏꯗ
এল্লায়েন্স	ꯑꯦꯜꯂꯥꯌꯦꯟꯁ
এস	ꯑꯦꯁ
এসপি	ꯑꯦꯁꯄꯤ
এসাইন	ꯑꯦꯁꯥꯏꯟ
এসাইনমেন্ট	ꯑꯦꯁꯥꯏꯟꯃꯦꯟꯠ
এসিগী	ꯑꯦꯁꯤꯒꯤ
এসিষ্টেন্ট	ꯑꯦꯁꯤꯁꯇ꯭ꯦꯟꯇ
এসিষ্টেন্স	ꯑꯦꯁꯤꯁꯇ꯭ꯦꯟꯁ
এসিয়া	ꯑꯦꯁꯤꯌꯥ
এসিয়াগী	ꯑꯦꯁꯤꯌꯥꯒꯤ
এসিয়াদগী	ꯑꯦꯁꯤꯌꯥꯗꯒꯤ
এসিয়াদা	ꯑꯦꯁꯤꯌꯥꯗꯥ
এসিয়ান	ꯑꯦꯁꯤꯌꯥꯟ
এসে	ꯑꯦꯁꯦ
এসেমব্লি	ꯑꯦꯁꯦꯃꯕꯂꯤ
এসেমব্লিগী	ꯑꯦꯁꯦꯃꯕꯂꯤꯒꯤ
এসেমব্লিদা	ꯑꯦꯁꯦꯃꯕꯂꯤꯗꯥ
এসেমব্লিনা	ꯑꯦꯁꯦꯃꯕꯂꯤꯅꯥ
এয়ার	ꯑꯦꯌꯥꯔ
এৱারনেস	ꯑꯦꯋꯥꯔꯅꯦꯁ
এৱার্ড	ꯑꯦꯋꯥꯔꯗ
এৱার্ডশিং	ꯑꯦꯋꯥꯔꯗꯁꯤꯡ
এৱার্দ	ꯑꯦꯋꯥꯔꯗ
এৱার্দকী	ꯑꯦꯋꯥꯔꯗꯀꯤ
এৱার্দশিং	ꯑꯦꯋꯥꯔꯗꯁꯤꯡ
এৱার্দস	ꯑꯦꯋꯥꯔꯗꯁ
এৱার্দি	ꯑꯦꯋꯥꯔꯗꯤ
ঐ	ꯑꯩ
ঐগা	ꯑꯩꯒꯥ
ঐগী	ꯑꯩꯒꯤ
ঐগীদি	ꯑꯩꯒꯤꯗꯤ
ঐগীনি	ꯑꯩꯒꯤꯅꯤ
ঐগীসু	ꯑꯩꯒꯤꯁꯨ
ঐগুম্বা	ꯑꯩꯒꯨꯝꯕꯥ
ঐগেজাং	ꯑꯩꯒꯦꯖꯥꯡ
ঐচ	ꯑꯩꯆ
ঐতিহাসিক	ꯑꯩꯇꯤꯍꯥꯁꯤꯛ
ঐদি	ꯑꯩꯗꯤ
ঐনবু	ꯑꯩꯅꯕꯨ
ঐনা	ꯑꯩꯅꯥ
ঐনি	ꯑꯩꯅꯤ
ঐবু	ꯑꯩꯕꯨ
ঐবুসু	ꯑꯩꯕꯨꯁꯨ
ঐসু	ꯑꯩꯁꯨ
ঐসে	ꯑꯩꯁꯦ
ঐহাক	ꯑꯩꯍꯥꯀ
ঐহাক্কি	ꯑꯩꯍꯥꯛꯀꯤ
ঐহাক্না	ꯑꯩꯍꯥꯛꯅꯥ
ও	ꯑꯣ
ওংবী	ꯑꯣꯡꯕꯤ
ওই	ꯑꯣꯏ
ওইখি	ꯑꯣꯏꯈꯤ
ওইখিদে	ꯑꯣꯏꯈꯤꯗꯦ
ওইখিবগা	ꯑꯣꯏꯈꯤꯕꯒꯥ
ওইখিবগী	ꯑꯣꯏꯈꯤꯕꯒꯤ
ওইখিবগুম	ꯑꯣꯏꯈꯤꯕꯒꯨꯝ
ওইখিবদগী	ꯑꯣꯏꯈꯤꯕꯗꯒꯤ
ওইখিবদু	ꯑꯣꯏꯈꯤꯕꯗꯨ
ওইখিবনা	ꯑꯣꯏꯈꯤꯕꯅꯥ
ওইখিবনি	ꯑꯣꯏꯈꯤꯕꯅꯤ
ওইখিবশিং	ꯑꯣꯏꯈꯤꯕꯁꯤꯡ
ওইখিবশিংগী	ꯑꯣꯏꯈꯤꯕꯁꯤꯡꯒꯤ
ওইখিবা	ꯑꯣꯏꯈꯤꯕꯥ
ওইখিবী	ꯑꯣꯏꯈꯤꯕꯤ
ওইখ্রবনি	ꯑꯣꯏꯈꯔ꯭ꯕꯅꯤ
ওইখ্রবশিং	ꯑꯣꯏꯈꯔ꯭ꯕꯁꯤꯡ
ওইখ্রবশিংগী	ꯑꯣꯏꯈꯔ꯭ꯕꯁꯤꯡꯒꯤ
ওইখ্রবা	ꯑꯣꯏꯈꯔ꯭ꯕꯥ
ওইখ্রবী	ꯑꯣꯏꯈꯔ꯭ꯕꯤ
ওইখ্রে	ꯑꯣꯏꯈꯔꯦ
ওইগদগে	ꯑꯣꯏꯒꯗꯒꯦ
ওইগদবনা	ꯑꯣꯏꯒꯗꯕꯅꯥ
ওইগদবনি	ꯑꯣꯏꯒꯗꯕꯅꯤ
ওইগদবশিংগী	ꯑꯣꯏꯒꯗꯕꯁꯤꯡꯒꯤ
ওইগদবা	ꯑꯣꯏꯒꯗꯕꯥ
ওইগদ্রা	ꯑꯣꯏꯒꯗꯔꯥ
ওইগনি	ꯑꯣꯏꯒꯅꯤ
ওইগা	ꯑꯣꯏꯒꯥ
ওইগে	ꯑꯣꯏꯒꯦ
ওইগেরা	ꯑꯣꯏꯒꯦꯔꯥ
ওইজগে	ꯑꯣꯏꯖꯒꯦ
ওইজবা	ꯑꯣꯏꯖꯕꯥ
ওইজরগে	ꯑꯣꯏꯖꯔꯒꯦ
ওইজরবসু	ꯑꯣꯏꯖꯔꯕꯁꯨ
ওইথংবা	ꯑꯣꯏꯊꯪꯕꯥ
ওইদ	ꯑꯣꯏꯗ
ওইদবা	ꯑꯣꯏꯗꯕꯥ
ওইদুনসু	ꯑꯣꯏꯗꯨꯅꯁꯨ
ওইদুনা	ꯑꯣꯏꯗꯨꯅꯥ
ওইদে	ꯑꯣꯏꯗꯦ
ওইদ্রবসু	ꯑꯣꯏꯗꯔ꯭ꯕꯁꯨ
ওইদ্রে	ꯑꯣꯏꯗꯔꯦ
ওইন	ꯑꯣꯏꯅ
ওইনদি	ꯑꯣꯏꯅꯗꯤ
ওইননবা	ꯑꯣꯏꯅꯅꯕꯥ
ওইননি	ꯑꯣꯏꯅꯅꯤ
ওইনবগী	ꯑꯣꯏꯅꯕꯒꯤ
ওইনবগীদমক	ꯑꯣꯏꯅꯕꯒꯤꯗꯃꯛ
ওইনবা	ꯑꯣꯏꯅꯕꯥ
ওইনমক	ꯑꯣꯏꯅꯃꯛ
ওইনসু	ꯑꯣꯏꯅꯁꯨ
ওইনা	ꯑꯣꯏꯅꯥ
ওইনাম	ꯑꯣꯏꯅꯥꯝ
ওইনামগী	ꯑꯣꯏꯅꯥꯝꯒꯤ
ওইনামনা	ꯑꯣꯏꯅꯥꯝꯅꯥ
ওইনিংবা	ꯑꯣꯏꯅꯤꯡꯕꯥ
ওইফম	ꯑꯣꯏꯐꯝ
ওইব	ꯑꯣꯏꯕ
ওইবগা	ꯑꯣꯏꯕꯒꯥ
ওইবগী	ꯑꯣꯏꯕꯒꯤ
ওইবগুম	ꯑꯣꯏꯕꯒꯨꯝ
ওইবতা	ꯑꯣꯏꯕꯇꯥ
ওইবতাই	ꯑꯣꯏꯕꯇꯥꯏ
ওইবদগী	ꯑꯣꯏꯕꯗꯒꯤ
ওইবদা	ꯑꯣꯏꯕꯗꯥ
ওইবদি	ꯑꯣꯏꯕꯗꯤ
ওইবনা	ꯑꯣꯏꯕꯅꯥ
ওইবনি	ꯑꯣꯏꯕꯅꯤ
ওইবশিং	ꯑꯣꯏꯕꯁꯤꯡ
ওইবশিংগা	ꯑꯣꯏꯕꯁꯤꯡꯒꯥ
ওইবশিংগী	ꯑꯣꯏꯕꯁꯤꯡꯒꯤ
ওইবশিংনা	ꯑꯣꯏꯕꯁꯤꯡꯅꯥ
ওইবা	ꯑꯣꯏꯕꯥ
ওইবী	ꯑꯣꯏꯕꯤ
ওইবীশিংনা	ꯑꯣꯏꯕꯤꯁꯤꯡꯅꯥ
ওইবীশিংবু	ꯑꯣꯏꯕꯤꯁꯤꯡꯕꯨ
ওইব্রা	ꯑꯣꯏꯕꯔꯥ
ওইরকই	ꯑꯣꯏꯔꯛꯏ
ওইরকখি	ꯑꯣꯏꯔꯛꯈꯤ
ওইরকখিবগী	ꯑꯣꯏꯔꯛꯈꯤꯕꯒꯤ
ওইরকখিবনি	ꯑꯣꯏꯔꯛꯈꯤꯕꯅꯤ
ওইরকপগা	ꯑꯣꯏꯔꯛꯄꯒꯥ
ওইরকপগী	ꯑꯣꯏꯔꯛꯄꯒꯤ
ওইরকপদগী	ꯑꯣꯏꯔꯛꯄꯗꯒꯤ
ওইরকপদা	ꯑꯣꯏꯔꯛꯄꯗꯥ
ওইরকপনা	ꯑꯣꯏꯔꯛꯄꯅꯥ
ওইরকপনি	ꯑꯣꯏꯔꯛꯄꯅꯤ
ওইরকপশিং	ꯑꯣꯏꯔꯛꯄꯁꯤꯡ
ওইরকপা	ꯑꯣꯏꯔꯛꯄꯥ
ওইরক্কদগে	ꯑꯣꯏꯔꯛꯀꯗꯒꯦ
ওইরক্কদবা	ꯑꯣꯏꯔꯛꯀꯗꯕꯥ
ওইরক্কনি	ꯑꯣꯏꯔꯛꯀꯅꯤ
ওইরক্নবা	ꯑꯣꯏꯔꯛꯅꯕꯥ
ওইরক্লগনি	ꯑꯣꯏꯔꯛꯂꯒꯅꯤ
ওইরক্লবদি	ꯑꯣꯏꯔꯛꯂꯕꯗꯤ
ওইরক্লবা	ꯑꯣꯏꯔꯛꯂꯕꯥ
ওইরক্লি	ꯑꯣꯏꯔꯛꯂꯤ
ওইরক্লিবশিং	ꯑꯣꯏꯔꯛꯂꯤꯕꯁꯤꯡ
ওইরক্লিবশিংগী	ꯑꯣꯏꯔꯛꯂꯤꯕꯁꯤꯡꯒꯤ
ওইরক্লিবা	ꯑꯣꯏꯔꯛꯂꯤꯕꯥ
ওইরক্লে	ꯑꯣꯏꯔꯛꯂꯦ
ওইরগদি	ꯑꯣꯏꯔꯒꯗꯤ
ওইরগনি	ꯑꯣꯏꯔꯒꯅꯤ
ওইরগা	ꯑꯣꯏꯔꯒꯥ
ওইরগে	ꯑꯣꯏꯔꯒꯦ
ওইরদুনা	ꯑꯣꯏꯔꯗꯨꯅꯥ
ওইরনি	ꯑꯣꯏꯔꯅꯤ
ওইরপ	ꯑꯣꯏꯔꯞ
ওইরপ্না	ꯑꯣꯏꯔꯞꯅꯥ
ওইরবগে	ꯑꯣꯏꯔꯕꯒꯦ
ওইরবদা	ꯑꯣꯏꯔꯕꯗꯥ
ওইরবদি	ꯑꯣꯏꯔꯕꯗꯤ
ওইরবনিনা	ꯑꯣꯏꯔꯕꯅꯤꯅꯥ
ওইরবশিং	ꯑꯣꯏꯔꯕꯁꯤꯡ
ওইরবশিংগী	ꯑꯣꯏꯔꯕꯁꯤꯡꯒꯤ
ওইরবশিংদা	ꯑꯣꯏꯔꯕꯁꯤꯡꯗꯥ
ওইরবসু	ꯑꯣꯏꯔꯕꯁꯨ
ওইরবা	ꯑꯣꯏꯔꯕꯥ
ওইরবী	ꯑꯣꯏꯔꯕꯤ
ওইরব্রা	ꯑꯣꯏꯔꯕꯔꯥ
ওইরমখি	ꯑꯣꯏꯔꯝꯈꯤ
ওইরমগনি	ꯑꯣꯏꯔꯝꯒꯅꯤ
ওইরম্বদগী	ꯑꯣꯏꯔꯝꯕꯗꯒꯤ
ওইরম্বদু	ꯑꯣꯏꯔꯝꯕꯗꯨ
ওইরম্বনি	ꯑꯣꯏꯔꯝꯕꯅꯤ
ওইরম্বশিং	ꯑꯣꯏꯔꯝꯕꯁꯤꯡ
ওইরম্বা	ꯑꯣꯏꯔꯝꯕꯥ
ওইরম্বী	ꯑꯣꯏꯔꯝꯕꯤ
ওইরম্মী	ꯑꯣꯏꯔꯝꯃꯤ
ওইরম্মে	ꯑꯣꯏꯔꯝꯃꯦ
ওইরম্লিবা	ꯑꯣꯏꯔꯝꯂꯤꯕꯥ
ওইরম্লে	ꯑꯣꯏꯔꯝꯂꯦ
ওইরসনু	ꯑꯣꯏꯔꯁꯅꯨ
ওইরসু	ꯑꯣꯏꯔꯁꯨ
ওইরি	ꯑꯣꯏꯔꯤ
ওইরিগবা	ꯑꯣꯏꯔꯤꯒꯕꯥ
ওইরিঙৈ	ꯑꯣꯏꯔꯤꯉꯩ
ওইরিঙৈদা	ꯑꯣꯏꯔꯤꯉꯩꯗꯥ
ওইরিনি	ꯑꯣꯏꯔꯤꯅꯤ
ওইরিবনি	ꯑꯣꯏꯔꯤꯕꯅꯤ
ওইরিবশিং	ꯑꯣꯏꯔꯤꯕꯁꯤꯡ
ওইরিবশিংগী	ꯑꯣꯏꯔꯤꯕꯁꯤꯡꯒꯤ
ওইরিবশিংদা	ꯑꯣꯏꯔꯤꯕꯁꯤꯡꯗꯥ
ওইরিবশিংনা	ꯑꯣꯏꯔꯤꯕꯁꯤꯡꯅꯥ
ওইরিবশিংবু	ꯑꯣꯏꯔꯤꯕꯁꯤꯡꯕꯨ
ওইরিবা	ꯑꯣꯏꯔꯤꯕꯥ
ওইরিবী	ꯑꯣꯏꯔꯤꯕꯤ
ওইরে	ꯑꯣꯏꯔꯦ
ওইল	ꯑꯣꯏꯜ
ওইশিল্লক্লে	ꯑꯣꯏꯁꯤꯜꯂꯛꯂꯦ
ওইসনু	ꯑꯣꯏꯁꯅꯨ
ওইহনগদবনি	ꯑꯣꯏꯍꯟꯒꯗꯕꯅꯤ
ওইহনগনি	ꯑꯣꯏꯍꯟꯒꯅꯤ
ওইহনদুনা	ꯑꯣꯏꯍꯟꯗꯨꯅꯥ
ওইহনবগী	ꯑꯣꯏꯍꯟꯕꯒꯤ
ওইহনবতা	ꯑꯣꯏꯍꯟꯕꯇꯥ
ওইহনবদা	ꯑꯣꯏꯍꯟꯕꯗꯥ
ওইহনবনি	ꯑꯣꯏꯍꯟꯕꯅꯤ
ওইহনবসু	ꯑꯣꯏꯍꯟꯕꯁꯨ
ওইহনবা	ꯑꯣꯏꯍꯟꯕꯥ
ওইহনসি	ꯑꯣꯏꯍꯟꯁꯤ
ওইহন্দুনা	ꯑꯣꯏꯍꯟꯗꯨꯅꯥ
ওইহন্ননবা	ꯑꯣꯏꯍꯟꯅꯅꯕꯥ
ওইহন্নবগী	ꯑꯣꯏꯍꯟꯅꯕꯒꯤ
ওইহন্নবগীনি	ꯑꯣꯏꯍꯟꯅꯕꯒꯤꯅꯤ
ওইহন্নবনি	ꯑꯣꯏꯍꯟꯅꯕꯅꯤ
ওইহন্নবা	ꯑꯣꯏꯍꯟꯅꯕꯥ
ওইহল্লকখিবনি	ꯑꯣꯏꯍꯜꯂꯛꯈꯤꯕꯅꯤ
ওইহল্লকপনি	ꯑꯣꯏꯍꯜꯂꯛꯄꯅꯤ
ওইহল্লকপা	ꯑꯣꯏꯍꯜꯂꯛꯄꯥ
ওইহল্লক্নবা	ꯑꯣꯏꯍꯜꯂꯛꯅꯕꯥ
ওইহল্লক্লিবা	ꯑꯣꯏꯍꯜꯂꯛꯂꯤꯕꯥ
ওইহল্লগনি	ꯑꯣꯏꯍꯜꯂꯒꯅꯤ
ওইহল্লগা	ꯑꯣꯏꯍꯜꯂꯒꯥ
ওইহল্লসি	ꯑꯣꯏꯍꯜꯂꯁꯤ
ওইহল্লি	ꯑꯣꯏꯍꯜꯂꯤ
ওইহল্লু	ꯑꯣꯏꯍꯜꯂꯨ
ওইহল্লে	ꯑꯣꯏꯍꯜꯂꯦ
ওক	ꯑꯣꯛ
ওকই	ꯑꯣꯛꯏ
ওকখি	ꯑꯣꯛꯈꯤ
ওকখিবা	ꯑꯣꯛꯈꯤꯕꯥ
ওকখ্রে	ꯑꯣꯛꯈꯔꯦ
ওকপগা	ꯑꯣꯛꯄꯒꯤ
ওকপগী	ꯑꯣꯛꯄꯒꯤ
ওকপদা	ꯑꯣꯛꯄꯗꯥ
ওকপা	ꯑꯣꯛꯄꯥ
ওকপীবা	ꯑꯣꯛꯞꯤꯕꯥ
ওকশা	ꯑꯣꯛꯁꯥ
ওক্কনি	ꯑꯣꯛꯀꯅꯤ
ওক্সিজেন	ꯑꯣꯛꯁꯤꯖꯦꯟ
ওগষ্ট	ꯑꯣꯒꯁꯠ
ওগষ্টকী	ꯑꯣꯒꯁꯠꯀꯤ
ওজা	ꯑꯣꯖꯥ
ওজাগী	ꯑꯣꯖꯥꯒꯤ
ওজানা	ꯑꯣꯖꯥꯅꯥ
ওজাশিং	ꯑꯣꯖꯥꯁꯤꯡ
ওজাশিংগা	ꯑꯣꯖꯥꯁꯤꯡꯒꯥ
ওজাশিংগী	ꯑꯣꯖꯥꯁꯤꯡꯒꯤ
ওজাশিংদা	ꯑꯣꯖꯥꯁꯤꯡꯗꯥ
ওজাশিংনা	ꯑꯣꯖꯥꯁꯤꯡꯅꯥ
ওদর	ꯑꯣꯗꯔ
ওদিও	ꯑꯣꯗꯤꯑꯣ
ওদিট	ꯑꯣꯗꯤꯠ
ওন	ꯑꯣꯟ
ওনখি	ꯑꯣꯟꯈꯤ
ওনখ্রবা	ꯑꯣꯟꯈꯔ꯭ꯕꯥ
ওনখৎনবা	ꯑꯣꯟꯈꯠꯅꯕꯥ
ওনখৎপা	ꯑꯣꯟꯈꯠꯄꯥ
ওনবগী	ꯑꯣꯟꯕꯒꯤ
ওনবা	ꯑꯣꯟꯕꯥ
ওনর	ꯑꯣꯅꯔ
ওনরেরি	ꯑꯣꯅꯔꯦꯔꯤ
ওনরেরিয়ম	ꯑꯣꯅꯔꯦꯔꯤꯌꯝ
ওনর্স	ꯑꯣꯅꯔꯁ
ওনলাইন	ꯑꯣꯟꯂꯥꯏꯟ
ওনলাইনগী	ꯑꯣꯟꯂꯥꯏꯟꯒꯤ
ওনলাইনদা	ꯑꯣꯟꯂꯥꯏꯟꯗꯥ
ওনশিন্নবা	ꯑꯣꯟꯁꯤꯟꯅꯕꯥ
ওনশিল্লে	ꯑꯣꯟꯁꯤꯜꯂꯦ
ওন্দুনা	ꯑꯣꯟꯗꯨꯅꯥ
ওন্ন	ꯑꯣꯟꯅ
ওন্ননা	ꯑꯣꯟꯅꯅꯥ
ওন্নবগী	ꯑꯣꯟꯅꯕꯒꯤ
ওন্নবা	ꯑꯣꯟꯅꯕꯥ
ওন্না	ꯑꯣꯟꯅꯥ
ওপ	ꯑꯣꯞ
ওপন	ꯑꯣꯄꯟ
ওপরেট	ꯑꯣꯄꯔꯦꯠ
ওপরেটর	ꯑꯣꯄꯔꯦꯇꯔ
ওপরেটিং	ꯑꯣꯄꯔꯦꯇꯤꯡ
ওপরেটিব	ꯑꯣꯄꯔꯦꯇꯤꯕ
ওপরেসন	ꯑꯣꯄꯔꯦꯁꯟ
ওপরেসনদা	ꯑꯣꯄꯔꯦꯁꯟꯗꯥ
ওপরেসনশিং	ꯑꯣꯄꯔꯦꯁꯟꯁꯤꯡ
ওপরেসনেল	ꯑꯣꯄꯔꯦꯁꯅꯦꯜ
ওপিয়ম	ꯑꯣꯄꯤꯌꯝ
ওফ	ꯑꯣꯐ
ওফর	ꯑꯣꯐꯔ
ওফলাইনদা	ꯑꯣꯐꯂꯥꯏꯟꯗꯥ
ওফা	ꯑꯣꯐꯥ
ওফিস	ꯑꯣꯐꯤꯁ
ওফিসকা	ꯑꯣꯐꯤꯁꯀꯥ
ওফিসকী	ꯑꯣꯐꯤꯁꯀꯤ
ওফিসতগী	ꯑꯣꯐꯤꯁꯇꯒꯤ
ওফিসতসু	ꯑꯣꯐꯤꯁꯇꯁꯨ
ওফিসতা	ꯑꯣꯐꯤꯁꯇꯥ
ওফিসনা	ꯑꯣꯐꯤꯁꯅꯥ
ওফিসর	ꯑꯣꯐꯤꯁꯔ
ওফিসশিং	ꯑꯣꯐꯤꯁꯁꯤꯡ
ওফিসশিংগী	ꯑꯣꯐꯤꯁꯁꯤꯡꯒꯤ
ওফিসশিংদা	ꯑꯣꯐꯤꯁꯁꯤꯡꯗꯥ
ওফিসার	ꯑꯣꯐꯤꯁꯥꯔ
ওফিসারগী	ꯑꯣꯐꯤꯁꯥꯔꯒꯤ
ওফিসারদা	ꯑꯣꯐꯤꯁꯥꯔꯗꯥ
ওফিসারনা	ꯑꯣꯐꯤꯁꯥꯔꯅꯥ
ওফিসারশিং	ꯑꯣꯐꯤꯁꯥꯔꯁꯤꯡ
ওফিসারশিংগা	ꯑꯣꯐꯤꯁꯥꯔꯁꯤꯡꯒꯥ
ওফিসারশিংগী	ꯑꯣꯐꯤꯁꯥꯔꯁꯤꯡꯒꯤ
ওফিসারশিংনা	ꯑꯣꯐꯤꯁꯥꯔꯁꯤꯡꯅꯥ
ওফিসিয়েল	ꯑꯣꯐꯤꯁꯤꯌꯦꯜ
ওফিসিয়েলশিং	ꯑꯣꯐꯤꯁꯤꯌꯦꯜꯁꯤꯡ
ওফিসিয়েলশিংগা	ꯑꯣꯐꯤꯁꯤꯌꯦꯜꯁꯤꯡꯒꯥ
ওফিসিয়েলশিংগী	ꯑꯣꯐꯤꯁꯤꯌꯦꯜꯁꯤꯡꯒꯤ
ওফিসিয়েলশিংদা	ꯑꯣꯐꯤꯁꯤꯌꯦꯜꯁꯤꯡꯗꯥ
ওফিসিয়েলশিংনা	ꯑꯣꯐꯤꯁꯤꯌꯦꯜꯁꯤꯡꯅꯥ
ওফিসিয়েলশিংসু	ꯑꯣꯐꯤꯁꯤꯌꯦꯜꯁꯤꯡꯁꯨ
ওবজার্বর	ꯑꯣꯕꯖꯥꯔꯕꯔ
ওবজার্বেসন	ꯑꯣꯕꯖꯥꯔꯕꯦꯁꯟ
ওবজেক্সন	ꯑꯣꯕꯖꯦꯛꯁꯟ
ওভর	ꯑꯣꯚꯔ
ওভেল	ꯑꯣꯚꯦꯜ
ওম	ꯑꯣꯝ
ওর	ꯑꯣꯔ
ওরিজিনেল	ꯑꯣꯔꯤꯖꯤꯅꯦꯜ
ওরিয়েন্টেল	ꯑꯣꯔꯤꯌꯦꯟꯇꯦꯜ
ওরেঞ্জ	ꯑꯣꯔꯦꯟꯖ
ওরেল	ꯑꯣꯔꯦꯜ
ওর্গনাইজিং	ꯑꯣꯔꯒꯅꯥꯏꯖꯤꯡ
ওর্গনাইজেসন	ꯑꯣꯔꯒꯅꯥꯏꯖꯦꯁꯟ
ওর্গনাইজেসনগী	ꯑꯣꯔꯒꯅꯥꯏꯖꯦꯁꯟꯒꯤ
ওর্গনাইজেসননা	ꯑꯣꯔꯒꯅꯥꯏꯖꯦꯁꯟꯅꯥ
ওর্গনাইজেসনশিং	ꯑꯣꯔꯒꯅꯥꯏꯖꯦꯁꯟꯁꯤꯡ
ওর্গনাইজেসনশিংগা	ꯑꯣꯔꯒꯅꯥꯏꯖꯦꯁꯟꯁꯤꯡꯒꯥ
ওর্গনাইজেসনশিংনা	ꯑꯣꯔꯒꯅꯥꯏꯖꯦꯁꯟꯁꯤꯡꯅꯥ
ওর্গনাইজেসন্না	ꯑꯣꯔꯒꯅꯥꯏꯖꯦꯁꯟꯅꯥ
ওর্গানাইজেসন	ꯑꯣꯔꯒꯥꯅꯥꯏꯖꯦꯁꯟ
ওর্গানাইজেসনগী	ꯑꯣꯔꯒꯥꯅꯥꯏꯖꯦꯁꯟꯒꯤ
ওর্গানাইজেসননা	ꯑꯣꯔꯒꯥꯅꯥꯏꯖꯦꯁꯟꯅꯥ
ওর্গানাইজেসনশিং	ꯑꯣꯔꯒꯥꯅꯥꯏꯖꯦꯁꯟꯁꯤꯡ
ওর্গানাইজেসনশিংগী	ꯑꯣꯔꯒꯥꯅꯥꯏꯖꯦꯁꯟꯁꯤꯡꯒꯤ
ওর্গানাইজেসনশিংনা	ꯑꯣꯔꯒꯥꯅꯥꯏꯖꯦꯁꯟꯁꯤꯡꯅꯥ
ওর্গানিক	ꯑꯣꯔꯒꯥꯅꯤꯛ
ওর্গানিক্কী	ꯑꯣꯔꯒꯥꯅꯤꯛꯀꯤ
ওর্গেনাইজেসন	ꯑꯣꯔꯒꯦꯅꯥꯏꯖꯦꯁꯟ
ওর্দর	ꯑꯣꯔꯗꯔ
ওর্দরগী	ꯑꯣꯔꯗꯔꯒꯤ
ওর্দরদা	ꯑꯣꯔꯗꯔꯗꯥ
ওর্দরশিং	ꯑꯣꯔꯗꯔꯁꯤꯡ
ওর্দিনান্স	ꯑꯣꯔꯗꯤꯅꯥꯟꯁ
ওর্ফানেজ	ꯑꯣꯔꯐꯥꯅꯦꯖ
ওল	ꯑꯣꯜ
ওলহন্নবা	ꯑꯣꯜꯍꯟꯅꯕꯥ
ওলাং	ꯑꯣꯂꯥꯡ
ওলেম্পিক	ꯑꯣꯂꯦꯝꯄꯤꯛ
ওলেম্পিক্স	ꯑꯣꯂꯦꯝꯄꯤꯀꯁ꯭
ওল্ড	ꯑꯣꯜꯗ
ওল্লকপা	ꯑꯣꯜꯂꯛꯄꯥ
ওল্লগা	ꯑꯣꯜꯂꯒꯥ
ওল্লবা	ꯑꯣꯜꯂꯕꯥ
ওল্লাংথাগী	ꯑꯣꯜꯂꯥꯡꯊꯥꯒꯤ
ওল্লি	ꯑꯣꯜꯂꯤ
ওল্লে	ꯑꯣꯜꯂꯦ
ওষ্ট্রেলিয়াগী	ꯑꯣꯁꯇ꯭ꯔꯦꯂꯤꯌꯥꯒꯤ
ওষ্ট্রেলিয়ানা	ꯑꯣꯁꯇ꯭ꯔꯦꯂꯤꯌꯥꯅꯥ
ওস্কার	ꯑꯣꯁꯀꯥꯔ
ওৎ	ꯑꯣꯠ
ওৎপা	ꯑꯣꯠꯄꯥ
ওৎপী	ꯑꯣꯠꯄꯤ
ওয়	ꯑꯣꯌ
ঔরঙ্গবাদ	ꯑꯧꯔꯡꯒꯕꯥꯗ
ক	ꯀ
কংগ্রেস	ꯀꯪꯒꯔꯦꯁ
কংগ্রেসকী	ꯀꯪꯒꯔꯦꯁꯀꯤ
কংগ্রেসতগী	ꯀꯪꯒꯔꯦꯁꯇꯒꯤ
কংগ্রেসতা	ꯀꯪꯒꯔꯦꯁꯇꯥ
কংগ্রেসনসু	ꯀꯪꯒꯔꯦꯁꯅꯁꯨ
কংগ্রেসনা	ꯀꯪꯒꯔꯦꯁꯅꯥ
কংগ্রেসপু	ꯀꯪꯒꯔꯦꯁꯄꯨ
কংদুনা	ꯀꯪꯗꯨꯅꯥ
কংনা	ꯀꯪꯅꯥ
কংফাল	ꯀꯪꯐꯥꯜ
কংফালগী	ꯀꯪꯐꯥꯜꯒꯤ
কংবগী	ꯀꯪꯕꯒꯤ
কংলবা	ꯀꯪꯂꯕꯥ
কংলা	ꯀꯪꯂꯥ
কংলাগী	ꯀꯪꯂꯥꯒꯤ
কংলাদগী	ꯀꯪꯂꯥꯗꯒꯤ
কংলাদা	ꯀꯪꯂꯥꯗꯥ
কংলৈ	ꯀꯪꯂꯩ
কংলৈপাক	ꯀꯪꯂꯩꯄꯥꯛ
কংলৈপাক্কী	ꯀꯪꯂꯩꯄꯥꯛꯀꯤ
কংশিল্লকপগী	ꯀꯪꯁꯤꯜꯂꯛꯄꯒꯤ
ককখি	ꯀꯛꯈꯤ
ককখ্রে	ꯀꯛꯈꯔꯦ
ককচিং	ꯀꯛꯆꯤꯡ
ককচিংগী	ꯀꯛꯆꯤꯡꯒꯤ
ককচিংতাবম	ꯀꯛꯆꯤꯡꯇꯥꯕꯝ
ককচিংদগী	ꯀꯛꯆꯤꯡꯗꯒꯤ
ককচিংদা	ꯀꯛꯆꯤꯡꯗꯥ
ককচিংনা	ꯀꯛꯆꯤꯡꯅꯥ
ককথৎখিবনি	ꯀꯛꯊꯠꯈꯤꯕꯅꯤ
ককথৎখ্রে	ꯀꯛꯊꯠꯈꯔꯦ
ককথৎলগা	ꯀꯛꯊꯠꯂꯒꯥ
ককপা	ꯀꯛꯄꯥ
কক্কনি	ꯀꯛꯀꯅꯤ
কক্নবা	ꯀꯛꯅꯕꯥ
কক্লগা	ꯀꯛꯂꯒꯥ
ককৱা	ꯀꯛꯋꯥ
ককৱাগী	ꯀꯛꯋꯥꯒꯤ
কছার	ꯀꯁꯥꯔ
কছারগী	ꯀꯁꯥꯔꯒꯤ
কছারদা	ꯀꯁꯥꯔꯗꯥ
কঞ্জনবগী	ꯀꯟꯖꯟꯕꯒꯤ
কঞ্জনবা	ꯀꯟꯖꯟꯕꯥ
কঞ্জারবেসন	ꯀꯟꯖꯥꯔꯕꯦꯁꯟ
কঞ্জার্বেসন	ꯀꯟꯖꯥꯔꯕꯦꯁꯟ
কঞ্জার্বেসনগী	ꯀꯟꯖꯥꯔꯕꯦꯁꯟꯒꯤ
কঞ্জুমর	ꯀꯟꯖꯨꯃꯔ
কট	ꯀꯠ
কটক	ꯀꯇꯛ
কটার	ꯀꯇꯥꯔ
কত্তুনা	ꯀꯠꯇꯨꯅꯥ
কথাইনবা	ꯀꯊꯥꯏꯟꯕꯥ
কদমতলা	ꯀꯗꯝꯇꯂꯥ
কদাই	ꯀꯗꯥꯏ
কদাইদগী	ꯀꯗꯥꯏꯗꯒꯤ
কদাইদা	ꯀꯗꯥꯏꯗꯥ
কদাইফাওবা	ꯀꯗꯥꯏꯐꯥꯎꯕꯥ
কদায়	ꯀꯗꯥꯌ
কনখি	ꯀꯟꯈꯤ
কনখু	ꯀꯟꯈꯨ
কনখ্রে	ꯀꯟꯈꯔꯦ
কনখৎনবা	ꯀꯟꯈꯠꯅꯕꯥ
কনখৎনরক্লি	ꯀꯟꯈꯠꯅꯔꯛꯂꯤ
কনখৎলকপা	ꯀꯟꯈꯠꯂꯛꯄꯥ
কনখৎলগনি	ꯀꯟꯈꯠꯂꯒꯅꯤ
কনখৎহনখি	ꯀꯟꯈꯠꯍꯟꯈꯤ
কনখৎহনগনি	ꯀꯟꯈꯠꯍꯟꯒꯅꯤ
কনখৎহনবদা	ꯀꯟꯈꯠꯍꯟꯕꯗꯥ
কনখৎহন্নবগী	ꯀꯟꯈꯠꯍꯟꯅꯕꯒꯤ
কনখৎহন্নবা	ꯀꯟꯈꯠꯍꯟꯅꯕꯥ
কনখৎহল্লে	ꯀꯟꯈꯠꯍꯜꯂꯦ
কনগনি	ꯀꯟꯒꯅꯤ
কনগে	ꯀꯟꯒꯦ
কনটেক্ট	ꯀꯟꯇꯦꯛꯇ
কনটেন্ট	ꯀꯟꯇꯦꯟꯠ
কনটেষ্ট	ꯀꯟꯇꯦꯁꯇ꯭
কনফরেন্স	ꯀꯟꯐꯔꯦꯟꯁ
কনফরেন্সকী	ꯀꯟꯐꯔꯦꯟꯁꯀꯤ
কনফরেন্সতা	ꯀꯟꯐꯔꯦꯟꯁꯇꯥ
কনফরেন্সিংগী	ꯀꯟꯐꯔꯦꯟꯁꯤꯡꯒꯤ
কনফার্ম	ꯀꯟꯐꯥꯔꯃ
কনফিদরেসনগী	ꯀꯟꯐꯤꯗꯔꯦꯁꯟꯒꯤ
কনফিদেন্স	ꯀꯟꯐꯤꯗꯦꯟꯁ
কনফেরেন্সিংগী	ꯀꯟꯐꯦꯔꯦꯟꯁꯤꯡꯒꯤ
কনফ্লিক	ꯀꯟꯐꯂꯤꯛ
কনবগা	ꯀꯟꯕꯒꯥ
কনবগী	ꯀꯟꯕꯒꯤ
কনবদগী	ꯀꯟꯕꯗꯒꯤ
কনবদা	ꯀꯟꯕꯗꯥ
কনবনা	ꯀꯟꯕꯅꯥ
কনবা	ꯀꯟꯕꯥ
কনবীবা	ꯀꯟꯕꯤꯕꯥ
কনভেনর	ꯀꯟꯚꯦꯅꯔ
কনভেন্সন	ꯀꯟꯚꯦꯟꯁꯟ
কনভেন্সনগী	ꯀꯟꯚꯦꯟꯁꯟꯒꯤ
কনভেন্সনদা	ꯀꯟꯚꯦꯟꯁꯟꯗꯥ
কনশিনবা	ꯀꯟꯁꯤꯅꯕꯥ
কনশিন্নবা	ꯀꯟꯁꯤꯟꯅꯕꯥ
কনশিন্না	ꯀꯟꯁꯤꯟꯅꯥ
কনশিল্লে	ꯀꯟꯁꯤꯜꯂꯦ
কনষ্ট্রক্সন	ꯀꯟꯁꯇ꯭ꯔꯛꯁꯟ
কনসি	ꯀꯟꯁꯤ
কনা	ꯀꯅꯥ
কনাগা	ꯀꯅꯥꯒꯥ
কনাগী	ꯀꯅꯥꯒꯤ
কনাগীসু	ꯀꯅꯥꯒꯤꯁꯨ
কনাগুম্বগী	ꯀꯅꯥꯒꯨꯝꯕꯒꯤ
কনাগুম্বনা	ꯀꯅꯥꯒꯨꯝꯕꯅꯥ
কনাগুম্বশিংনা	ꯀꯅꯥꯒꯨꯝꯕꯁꯤꯡꯅꯥ
কনাগুম্বা	ꯀꯅꯥꯒꯨꯝꯕꯥ
কনাদা	ꯀꯅꯥꯗꯥ
কনানসু	ꯀꯅꯥꯅꯁꯨ
কনানা	ꯀꯅꯥꯅꯥ
কনাবু	ꯀꯅꯥꯕꯨ
কনামত্তনা	ꯀꯅꯥꯃꯠꯇꯅꯥ
কনামত্তা	ꯀꯅꯥꯃꯠꯇꯥ
কনাসু	ꯀꯅꯥꯁꯨ
কনেক্সন	ꯀꯅꯦꯛꯁꯟ
কন্টেক	ꯀꯟꯇꯦꯛ
কন্টেক্ট	ꯀꯟꯇꯦꯛꯇ
কন্ট্রেক্ট	ꯀꯟꯇꯔꯦꯛꯇ
কন্দক্ট	ꯀꯟꯗꯛꯇ
কন্দক্টকী	ꯀꯟꯗꯛꯇꯀꯤ
কন্দিসন	ꯀꯟꯗꯤꯁꯟ
কন্ননবগী	ꯀꯟꯅꯅꯕꯒꯤ
কন্ননবগীদমক	ꯀꯟꯅꯒꯕꯒꯤꯗꯃꯛ
কন্ননবা	ꯀꯟꯅꯅꯕꯥ
কন্নবগী	ꯀꯟꯅꯕꯒꯤ
কন্নবগীদমক	ꯀꯟꯅꯕꯒꯤꯗꯃꯛ
কন্নবনি	ꯀꯟꯅꯕꯅꯤ
কন্নবা	ꯀꯟꯅꯕꯥ
কন্না	ꯀꯟꯅꯥ
কন্সটিট্যুন্সি	ꯀꯟꯁꯇꯤꯠꯇꯨꯟꯁꯤ
কন্সটিট্যুসন	ꯀꯟꯁꯇꯤꯠꯇꯨꯁꯟ
কন্সটিট্যুসনগী	ꯀꯟꯁꯇꯤꯠꯇꯨꯁꯟꯒꯤ
কন্সটিট্যুসনেল	ꯀꯟꯁꯇꯤꯠꯇꯨꯁꯅꯦꯜ
কন্সটিট্যুয়েন্সি	ꯀꯟꯁꯇꯤꯠꯇꯨꯌꯦꯟꯁꯤ
কন্সটিট্যুয়েন্সিগী	ꯀꯟꯁꯇꯤꯠꯇꯨꯌꯦꯟꯁꯤꯒꯤ
কন্সটিট্যুয়েন্সিদা	ꯀꯟꯁꯇꯤꯠꯇꯨꯌꯦꯟꯁꯤꯗꯥ
কন্সটিট্যুয়েন্সিনা	ꯀꯟꯁꯇꯤꯠꯇꯨꯌꯦꯟꯁꯤꯅꯥ
কন্সটিট্যুয়েন্সিশিং	ꯀꯟꯁꯇꯤꯠꯇꯨꯌꯦꯟꯁꯤꯁꯤꯡ
কন্সটেবল	ꯀꯟꯁꯇꯦꯕꯜ
কন্সট্রক্সন	ꯀꯟꯁꯇꯔꯛꯁꯟ
কন্সলটেটিব	ꯀꯟꯁꯜꯇꯦꯇꯤꯕ
কন্সলটেন্ট	ꯀꯟꯁꯜꯇꯦꯟꯠ
কন্সলটেসন	ꯀꯟꯁꯜꯇꯦꯁꯟ
কন্সেন্সস	ꯀꯟꯁꯦꯟꯁꯁ
কপ	ꯀꯞ
কপকী	ꯀꯞꯀꯤ
কপগী	ꯀꯞꯒꯤ
কপাংরিংনা	ꯀꯄꯥꯡꯔꯤꯡꯅꯥ
কপিল	ꯀꯄꯤꯜ
কপ্তা	ꯀꯞꯇꯥ
কপ্না	ꯀꯞꯅꯥ
কপ্পদা	ꯀꯞꯄꯗꯥ
কপ্পনা	ꯀꯞꯄꯅꯥ
কপ্পা	ꯀꯞꯄꯥ
কপ্পু	ꯀꯞꯄꯨ
কপ্লগা	ꯀꯞꯂꯒꯥ
কপ্লি	ꯀꯞꯂꯤ
কব	ꯀꯕ
কবি	ꯀꯕꯤ
কবিতা	ꯀꯕꯤꯇꯥ
কবিশিং	ꯀꯕꯤꯁꯤꯪ
কবুই	ꯀꯕꯨꯏ
কভরেজ	ꯀꯚꯔꯦꯖ
কম	ꯀꯝ
কমপ্রিহেন্সিভ	ꯀꯝꯄꯔꯤꯍꯦꯟꯁꯤꯚ
কমপ্লিট	ꯀꯝꯄꯂꯤꯠ
কমপ্লেইন	ꯀꯝꯞꯂꯦꯏꯟ
কমপ্লেক্স	ꯀꯝꯄꯂꯦꯛꯁ
কমপ্লেক্সতা	ꯀꯝꯄꯂꯦꯛꯁꯇꯥ
কমপ্লেক্সশিং	ꯀꯝꯞꯂꯦꯛꯁꯁꯤꯡ
কমপ্লেন	ꯀꯝꯄꯂꯦꯠ
কমপ্লেন্ট	ꯀꯝꯄꯂꯦꯟꯠ
কমল	ꯀꯃꯜ
কমলা	ꯀꯝꯂꯥ
কমালা	ꯀꯃꯥꯂꯥ
কমিতি	ꯀꯃꯤꯇꯤ
কমিসন	ꯀꯃꯤꯁꯟ
কমিসনগী	ꯀꯃꯤꯁꯟꯒꯤ
কমিসননা	ꯀꯃꯤꯁꯟꯅꯥ
কম্পনি	ꯀꯝꯄꯅꯤ
কম্পনিগী	ꯀꯝꯄꯅꯤꯒꯤ
কম্পনিদা	ꯀꯝꯄꯅꯤꯗꯥ
কম্পনিশিং	ꯀꯝꯄꯅꯤꯁꯤꯡ
কম্পনিশিংদা	ꯀꯝꯄꯅꯤꯁꯤꯡꯗꯥ
কম্পনিশিংনা	ꯀꯝꯄꯅꯤꯁꯤꯡꯅꯥ
কম্পলসরি	ꯀꯝꯄꯜꯁꯔꯤ
কম্পার্টমেন্ট	ꯀꯝꯄꯥꯔꯇꯃꯦꯟꯇ
কম্পিটিসন	ꯀꯝꯄꯤꯇꯤꯁꯟ
কম্পেনি	ꯀꯝꯄꯦꯅꯤ
কম্পেন্সেসন	ꯀꯝꯄꯦꯟꯁꯦꯁꯟ
কম্প্যুটর	ꯀꯝꯞꯖꯨꯇꯔ
কম্বাইন	ꯀꯝꯕꯥꯏꯟ
কম্বাইন্দ	ꯀꯝꯕꯥꯏꯟꯗ
কম্মন	ꯀꯝꯃꯟ
কম্মর্স	ꯀꯝꯃꯔꯁ
কম্মর্সনা	ꯀꯝꯃꯔꯁꯅꯥ
কম্মর্সিয়েল	ꯀꯝꯃꯔꯁꯤꯌꯦꯜ
কম্মান্দ	ꯀꯝꯃꯥꯟꯗ
কম্মান্দর	ꯀꯝꯃꯥꯟꯗꯔ
কম্মান্দরনা	ꯀꯝꯃꯥꯟꯗꯔꯅꯥ
কম্মান্দরনি	ꯀꯝꯃꯥꯟꯗꯔꯅꯤ
কম্মান্দিং	ꯀꯝꯃꯥꯟꯗꯤꯡ
কম্মান্দেন্ট	ꯀꯝꯃꯥꯟꯗꯦꯟꯇ
কম্মিং	ꯀꯝꯃꯤꯡ
কম্মিটি	ꯀꯝꯃꯤꯇꯤ
কম্মিতি	ꯀꯝꯃꯤꯇꯤ
কম্মিতিগী	ꯀꯝꯃꯤꯇꯤꯒꯤ
কম্মিসন	ꯀꯝꯃꯤꯁꯟ
কম্মিসনগা	ꯀꯝꯃꯤꯁꯟꯒꯥ
কম্মিসনগী	ꯀꯝꯃꯤꯁꯟꯒꯤ
কম্মিসনদা	ꯀꯝꯃꯤꯁꯟꯗꯥ
কম্মিসননা	ꯀꯝꯃꯤꯁꯟꯅꯥ
কম্মিসনার	ꯀꯝꯃꯤꯁꯅꯥꯔ
কম্মিসনারশিং	ꯀꯝꯃꯤꯁꯅꯥꯔꯁꯤꯡ
কম্মিসন্না	ꯀꯝꯃꯤꯁꯟꯅꯥ
কম্মিস্নার	ꯀꯝꯃꯤꯁꯅꯥꯔ
কম্মিস্নারদা	ꯀꯝꯃꯤꯁꯅꯥꯔꯗꯥ
কম্মিস্নারনা	ꯀꯝꯃꯤꯁꯅꯥꯔꯅꯥ
কম্মিস্নারশিংদা	ꯀꯝꯃꯤꯁꯅꯥꯔꯁꯤꯡꯗꯥ
কম্মিস্নারশিংনা	ꯀꯝꯃꯤꯁꯅꯥꯔꯁꯤꯡꯅꯥ
কম্মুনিকেসন	ꯀꯝꯃꯨꯅꯤꯀꯦꯁꯟ
কম্মুনিষ্ট	ꯀꯝꯃꯨꯅꯤꯁꯇ꯭
কম্ম্যুনিতি	ꯀꯝꯃꯌ꯭ꯨꯅꯤꯇꯤ
করপসন	ꯀꯔꯞꯁꯟ
করবার	ꯀꯔꯕꯥꯔ
করবারদা	ꯀꯔꯕꯥꯔꯗꯥ
করম	ꯀꯔꯝ
করম্না	ꯀꯔꯝꯅꯥ
করম্বনা	ꯀꯔꯝꯕꯅꯥ
করম্বা	ꯀꯔꯝꯕꯥ
করা	ꯀꯔꯥ
করাম	ꯀꯔꯥꯃ
করি	ꯀꯔꯤ
করিকুলম	ꯀꯔꯤꯀꯨꯂꯝ
করিগী	ꯀꯔꯤꯒꯤ
করিগীদমক	ꯀꯔꯤꯒꯤꯗꯃꯛ
করিগুম্বদা	ꯀꯔꯤꯒꯨꯝꯕꯗꯥ
করিগুম্বা	ꯀꯔꯤꯒꯨꯝꯕꯥ
করিদা	ꯀꯔꯤꯗꯥ
করিনে	ꯀꯔꯤꯅꯦ
করিমগঞ্জ	ꯀꯔꯤꯝꯒꯟꯖ
করিমত্তা	ꯀꯔꯤꯃꯠꯇꯥ
করিসু	ꯀꯔꯤꯁꯨ
করেন্ট	ꯀꯔꯦꯟꯇ
করেম	ꯀꯔꯦꯃ
করেম্নফম	ꯀꯔꯦꯝꯅꯐꯝ
কর্নেল	ꯀꯔꯅꯦꯜ
কর্ফিয়ু	ꯀꯔꯐꯤꯌꯨ
কলকতা	ꯀꯂꯛꯇꯥ
কলচর	ꯀꯜꯆꯔ
কলচরগা	ꯀꯜꯆꯔꯒꯥ
কলচরগী	ꯀꯜꯆꯔꯒꯤ
কলচরদা	ꯀꯜꯆꯔꯗꯥ
কলচরবু	ꯀꯜꯆꯔꯕꯨ
কলচরেল	ꯀꯜꯆꯔꯦꯜ
কলম	ꯀꯜꯃ
কলমনিষ্ট	ꯀꯂꯝꯅꯤꯁꯇ꯭
কলম্বিয়াগী	ꯀꯂꯝꯕꯤꯌꯥꯒꯤ
কলর	ꯀꯂꯔ
কলহনবা	ꯀꯜꯍꯟꯕꯥ
কলহন্নবা	ꯀꯜꯍꯟꯅꯕꯥ
কলা	ꯀꯂꯥ
কলাকার	ꯀꯂꯥꯀꯥꯔ
কলাম	ꯀꯂꯥꯝ
কলেক্সন	ꯀꯂꯦꯛꯁꯟ
কলেজ	ꯀꯂꯦꯖ
কলেজকী	ꯀꯂꯦꯖꯀꯤ
কলেজগী	ꯀꯂꯦꯖꯒꯤ
কলেজতা	ꯀꯂꯦꯖꯇꯥ
কলেজদগী	ꯀꯂꯦꯖꯗꯒꯤ
কলেজদসু	ꯀꯂꯦꯖꯗꯁꯨ
কলেজদা	ꯀꯂꯦꯖꯗꯥ
কলেজনা	ꯀꯂꯦꯖꯅꯥ
কলেজনি	ꯀꯂꯦꯖꯅꯤ
কলেজশিং	ꯀꯂꯦꯖꯁꯤꯡ
কলেজশিংগী	ꯀꯂꯦꯖꯁꯤꯡꯒꯤ
কলেজশিংদা	ꯀꯂꯦꯖꯁꯤꯡꯗꯥ
কলেজশিংনা	ꯀꯂꯦꯖꯁꯤꯡꯅꯥ
কলেজশিংসু	ꯀꯂꯦꯖꯁꯤꯡꯁꯨ
কল্লক	ꯀꯜꯂꯛ
কল্লকপা	ꯀꯜꯂꯛꯄꯥ
কল্লবা	ꯀꯜꯂꯕꯥ
কল্লি	ꯀꯜꯂꯤ
কল্লিবা	ꯀꯜꯂꯤꯕꯥ
কল্লে	ꯀꯜꯂꯦ
কল্লেক্সন	ꯀꯜꯂꯦꯛꯁꯟ
কষ্টদি	ꯀꯁꯇ꯭ꯗꯤ
কষ্টদিদা	ꯀꯁꯇ꯭ꯗꯤꯗꯥ
কষ্টম	ꯀꯁꯇ꯭ꯝ
কষ্টমর	ꯀꯁꯇ꯭ꯃꯔ
কা	ꯀꯥ
কাং	ꯀꯥꯡ
কাংখদা	ꯀꯥꯪꯈꯗꯥ
কাংখুৎনা	ꯀꯥꯡꯈꯨꯠꯅꯥ
কাংখুৎপু	ꯀꯥꯡꯈꯨꯠꯄꯨ
কাংগী	ꯀꯥꯡꯒꯤ
কাংঙুজম	ꯀꯥꯡꯉꯨꯖꯝ
কাংচুপ	ꯀꯥꯡꯆꯨꯄ
কাংজম	ꯀꯥꯡꯖꯝ
কাংজৈ	ꯀꯥꯡꯖꯩ
কাংজৈগী	ꯀꯥꯡꯖꯩꯒꯤ
কাংজৈবুং	ꯀꯥꯡꯖꯩꯕꯨꯡ
কাংজৈবুংগী	ꯀꯥꯡꯖꯩꯕꯨꯡꯒꯤ
কাংজৈবুংদা	ꯀꯥꯡꯖꯩꯕꯨꯡꯗꯥ
কাংদনা	ꯀꯥꯡꯗꯅꯥ
কাংব	ꯀꯥꯡꯕ
কাংবু	ꯀꯥꯡꯕꯨ
কাংবুগা	ꯀꯥꯡꯕꯨꯒꯥ
কাংবুনা	ꯀꯥꯡꯕꯨꯅꯥ
কাংলুপ	ꯀꯥꯡꯂꯨꯞ
কাংলুপকি	ꯀꯥꯡꯂꯨꯞꯀꯤ
কাংলুপকী	ꯀꯥꯡꯂꯨꯞꯀꯤ
কাংলুপশিংগী	ꯀꯥꯡꯂꯨꯞꯁꯤꯡꯒꯤ
কাংলেন	ꯀꯥꯡꯂꯦꯟ
কাইদা	ꯀꯥꯏꯗꯥ
কাইদুনা	ꯀꯥꯏꯗꯨꯅꯥ
কাইনথংদা	ꯀꯥꯏꯟꯊꯪꯗꯥ
কাইনা	ꯀꯥꯏꯅꯥ
কাইবা	ꯀꯥꯏꯕꯥ
কাওফম	ꯀꯥꯎꯐꯝ
কাওবা	ꯀꯥꯑꯣꯕꯥ
কাখি	ꯀꯥꯈꯤ
কাখিবনা	ꯀꯥꯈꯤꯕꯅꯥ
কাখিবনি	ꯀꯥꯈꯤꯕꯅꯤ
কাখিবা	ꯀꯥꯈꯤꯕꯥ
কাখ্রবনি	ꯀꯥꯈꯔ꯭ꯕꯅꯤ
কাখ্রবা	ꯀꯥꯈꯔ꯭ꯕꯥ
কাখ্রে	ꯀꯥꯈꯔꯦ
কাখৎখিবা	ꯀꯥꯈꯠꯈꯤꯕꯥ
কাগদবনি	ꯀꯥꯒꯗꯕꯅꯤ
কাগনি	ꯀꯥꯒꯅꯤ
কাঙবম	ꯀꯥꯉꯕꯝ
কাঙবু	ꯀꯥꯉꯕꯨ
কাঙবুশিংনা	ꯀꯥꯉꯕꯨꯁꯤꯪꯅꯥ
কাঙম	ꯀꯥꯉꯝ
কাচিন	ꯀꯥꯆꯤꯟ
কাচিন্দা	ꯀꯥꯆꯤꯟꯗꯥ
কাঞ্চিপুরদা	ꯀꯥꯟꯆꯤꯄꯨꯔꯗꯥ
কাদনবা	ꯀꯥꯗꯟꯕꯥ
কাদবা	ꯀꯥꯗꯕꯥ
কাদর	ꯀꯥꯗꯔ
কাদা	ꯀꯥꯗꯥ
কাদানা	ꯀꯥꯗꯥꯅꯥ
কাদুনা	ꯀꯥꯗꯨꯅꯥ
কানপুর	ꯀꯥꯟꯄꯨꯔ
কানপুরগী	ꯀꯥꯟꯄꯨꯔꯒꯤ
কানবা	ꯀꯥꯅꯕꯥ
কানা	ꯀꯥꯅꯥ
কানি	ꯀꯥꯅꯤ
কান্নগদবা	ꯀꯥꯟꯅꯒꯗꯕꯥ
কান্নগনি	ꯀꯥꯟꯅꯒꯅꯤ
কান্নদনা	ꯀꯥꯟꯅꯗꯅꯥ
কান্নদবা	ꯀꯥꯟꯅꯗꯕꯥ
কান্নদে	ꯀꯥꯟꯅꯗꯦ
কান্নদ্রবা	ꯀꯥꯟꯅꯗꯔ꯭ꯕꯥ
কান্নদ্রে	ꯀꯥꯟꯅꯗꯔꯦ
কান্ননবা	ꯀꯥꯟꯅꯅꯕꯥ
কান্ননিংঙাই	ꯀꯥꯟꯅꯅꯤꯡꯉꯥꯏ
কান্নবগী	ꯀꯥꯟꯅꯕꯒꯤ
কান্নবশিং	ꯀꯥꯟꯅꯕꯁꯤꯡ
কান্নবসু	ꯀꯥꯟꯅꯕꯁꯨ
কান্নবা	ꯀꯥꯟꯅꯕꯥ
কান্নরগা	ꯀꯥꯟꯅꯔꯒꯥ
কান্নরবা	ꯀꯥꯟꯅꯔꯕꯥ
কান্নহনবতা	ꯀꯥꯟꯅꯍꯟꯕꯇꯥ
কান্নহনবা	ꯀꯥꯟꯅꯍꯟꯕꯥ
কান্নহল্লগনি	ꯀꯥꯟꯅꯍꯜꯂꯒꯅꯤ
কান্নহল্লি	ꯀꯥꯟꯅꯍꯜꯂꯤ
কাপ	ꯀꯥꯞ
কাপকদবনি	ꯀꯥꯞꯀꯗꯕꯅꯤ
কাপকনি	ꯀꯥꯞꯀꯅꯤ
কাপখি	ꯀꯥꯞꯈꯤ
কাপখিবনি	ꯀꯥꯞꯈꯤꯕꯅꯤ
কাপখিবা	ꯀꯥꯞꯈꯤꯕꯥ
কাপখ্রে	ꯀꯥꯞꯈꯔꯦ
কাপতুনা	ꯀꯥꯞꯇꯨꯅꯥ
কাপফম	ꯀꯥꯄꯐꯝ
কাপশিন্দুনা	ꯀꯥꯞꯁꯤꯟꯗꯨꯅꯥ
কাপ্তুনা	ꯀꯥꯞꯇꯨꯅꯥ
কাপ্নখি	ꯀꯥꯞꯅꯈꯤ
কাপ্ননবগী	ꯀꯥꯞꯅꯅꯕꯒꯤ
কাপ্ননবা	ꯀꯥꯞꯅꯅꯕꯥ
কাপ্নবগী	ꯀꯥꯞꯅꯕꯒꯤ
কাপ্নবদা	ꯀꯥꯞꯅꯕꯗꯥ
কাপ্নবনি	ꯀꯥꯞꯅꯕꯅꯤ
কাপ্নবা	ꯀꯥꯞꯅꯕꯥ
কাপ্পগা	ꯀꯥꯞꯄꯒꯥ
কাপ্পগী	ꯀꯥꯞꯄꯒꯤ
কাপ্পদগী	ꯀꯥꯞꯄꯗꯒꯤ
কাপ্পদা	ꯀꯥꯞꯄꯗꯥ
কাপ্পা	ꯀꯥꯞꯄꯥ
কাপ্পী	ꯀꯥꯞꯄꯤ
কাপ্লকপা	ꯀꯥꯞꯂꯛꯄꯥ
কাপ্লগনি	ꯀꯥꯞꯂ꯭ꯒꯅꯤ
কাপ্লগা	ꯀꯥꯞꯂ꯭ꯒꯥ
কাপ্লবসু	ꯀꯥꯞꯂ꯭ꯕꯁꯨ
কাপ্লবা	ꯀꯥꯞꯂ꯭ꯕꯥ
কাপ্লি	ꯀꯥꯞꯂꯤ
কাপ্লিবা	ꯀꯥꯞꯂꯤꯕꯥ
কাবগী	ꯀꯥꯕꯒꯤ
কাবসু	ꯀꯥꯕꯁꯨ
কাবা	ꯀꯥꯕꯥ
কাবুল	ꯀꯥꯕꯨꯜ
কামৈ	ꯀꯥꯃꯩ
কার	ꯀꯥꯔ
কারকখি	ꯀꯥꯔꯛꯈꯤ
কারকখিবা	ꯀꯥꯔꯛꯈꯤꯕꯥ
কারকপগা	ꯀꯥꯔꯛꯄꯒꯥ
কারকপদা	ꯀꯥꯔꯛꯄꯗꯥ
কারকপনি	ꯀꯥꯔꯛꯄꯅꯤ
কারকপা	ꯀꯥꯔꯛꯄꯥ
কারক্লবা	ꯀꯥꯔꯛꯂꯕꯥ
কারগা	ꯀꯥꯔꯒꯥ
কারন	ꯀꯥꯔꯟ
কারবা	ꯀꯥꯔꯕꯥ
কারে	ꯀꯥꯔꯦ
কার্ড	ꯀꯥꯔꯗ
কার্দ	ꯀꯥꯔꯗ
কার্দকী	ꯀꯥꯔꯗꯀꯤ
কার্দসু	ꯀꯥꯔꯗꯁꯨ
কার্ফিয়ু	ꯀꯥꯔꯐꯤꯌꯨ
কার্ফিয়ুনা	ꯀꯥꯔꯐꯤꯌꯨꯅꯥ
কালা	ꯀꯥꯂꯥ
কালাপানিদা	ꯀꯥꯂꯥꯄꯥꯅꯤꯗꯥ
কালি	ꯀꯥꯂꯤ
কালিতানা	ꯀꯥꯂꯤꯇꯥꯅꯥ
কালেন	ꯀꯥꯂꯦꯟ
কালেনগী	ꯀꯥꯂꯦꯟꯒꯤ
কাশ্মির	ꯀꯥꯁꯃꯤꯔ
কাশ্মিরগী	ꯀꯥꯁꯃꯤꯔꯒꯤ
কাশ্মিরদা	ꯀꯥꯁꯃꯤꯔꯗꯥ
কাশ্মিরবু	ꯀꯥꯁꯃꯤꯔꯕꯨ
কাশ্মীর	ꯀꯥꯁꯃꯤꯔ
কাশ্মীরগী	ꯀꯥꯁꯃꯤꯔꯒꯤ
কাশ্মীরদগী	ꯀꯥꯁꯃꯤꯔꯗꯒꯤ
কাশ্মীরদা	ꯀꯥꯁꯃꯤꯔꯗꯥ
কাষ্ট	ꯀꯥꯁꯇ꯭
কাসিদা	ꯀꯥꯁꯤꯗꯥ
কাহনবা	ꯀꯥꯍꯟꯕꯥ
কায়খিবা	ꯀꯥꯢꯈꯤꯕꯥ
কায়গদবা	ꯀꯥꯢꯒꯗꯕꯥ
কায়দনবা	ꯀꯥꯢꯗꯅꯕꯥ
কায়দনা	ꯀꯥꯢꯗꯅꯥ
কায়দবা	ꯀꯥꯢꯗꯕꯥ
কায়নখ্রবা	ꯀꯥꯢꯅꯈꯔ꯭ꯕꯥ
কায়নবা	ꯀꯥꯢꯅꯕꯥ
কায়না	ꯀꯥꯢꯅꯥ
কায়বগী	ꯀꯥꯢꯕꯒꯤ
কায়বদগী	ꯀꯥꯢꯕꯗꯒꯤ
কায়বা	ꯀꯥꯢꯕꯥ
কায়রকপগী	ꯀꯥꯢꯔꯛꯄꯒꯤ
কায়রবা	ꯀꯥꯢꯔꯕꯥ
কায়হনদনা	ꯀꯥꯢꯍꯟꯗꯅꯥ
কায়হনবা	ꯀꯥꯢꯍꯟꯕꯥ
কায়হন্দনবা	ꯀꯥꯢꯍꯟꯗꯅꯕꯥ
কায়হন্দনা	ꯀꯥꯢꯍꯟꯗꯅꯥ
কায়হন্দবা	ꯀꯥꯢꯍꯟꯗꯕꯥ
কায়হল্লে	ꯀꯥꯢꯍꯜꯂꯦ
কি	ꯀꯤ
কিং	ꯀꯤꯡ
কিংদমগী	ꯀꯤꯡꯗꯝꯒꯤ
কিজৈ	ꯀꯤꯖꯩ
কিট	ꯀꯤꯇ
কিটচন	ꯀꯤꯇꯆꯟ
কিটশিং	ꯀꯤꯇꯁꯤꯡ
কিটস	ꯀꯤꯇꯁ
কিদ	ꯀꯤꯗ
কিদনি	ꯀꯤꯗꯅꯤ
কিদনিদা	ꯀꯤꯗꯅꯤꯗꯥ
কিদবা	ꯀꯤꯗꯕꯥ
কিদুনা	ꯀꯤꯗꯨꯅꯥ
কিনবা	ꯀꯤꯅꯕꯥ
কিনরম্মী	ꯀꯤꯅꯔꯝꯃꯤ
কিনরিবা	ꯀꯤꯅꯔꯤꯕꯥ
কিনরে	ꯀꯤꯅꯔꯦ
কিনা	ꯀꯤꯅꯥ
কিনিংঙাই	ꯀꯤꯅꯤꯡꯉꯥꯏ
কিন্দর	ꯀꯤꯟꯗꯔ
কিপগেন	ꯀꯤꯞꯒꯦꯟ
কিপ্পিং	ꯀꯤꯞꯄꯤꯡ
কিবগী	ꯀꯤꯕꯒꯤ
কিবদগী	ꯀꯤꯕꯗꯒꯤ
কিবনা	ꯀꯤꯕꯅꯥ
কিবা	ꯀꯤꯕꯥ
কিরন	ꯀꯤꯔꯟ
কিরনদা	ꯀꯤꯔꯟꯗꯥ
কিরননা	ꯀꯤꯔꯟꯅꯥ
কিরেন	ꯀꯤꯔꯦꯟ
কিশিল্লগা	ꯀꯤꯁꯤꯜꯂꯒꯥ
কিষন	ꯀꯤꯁꯟ
কিষননা	ꯀꯤꯁꯟꯅꯥ
কিষান	ꯀꯤꯁꯥꯅ
কিহন	ꯀꯤꯍꯟ
কিহনবগী	ꯀꯤꯍꯟꯕꯒꯤ
কিহল্লকপা	ꯀꯤꯍꯜꯂꯛꯄꯥ
কিহল্লি	ꯀꯤꯍꯜꯂꯤ
কিয়াম	ꯀꯤꯌꯥꯝ
কিয়ার	ꯀꯤꯌꯥꯔ
কিৱি	ꯀꯤꯋꯤ
কী	ꯀꯤ
কীদমক	ꯀꯤꯗꯃꯛ
কু	ꯀꯨ
কুংনা	ꯀꯨꯡꯅꯥ
কুইজকী	ꯀꯨꯏꯖꯀꯤ
কুইদনা	ꯀꯨꯏꯗꯅꯥ
কুইন	ꯀꯨꯏꯅ
কুইনগী	ꯀꯨꯏꯅꯒꯤ
কুইনদগী	ꯀꯨꯏꯅꯗꯒꯤ
কুইনা	ꯀꯨꯏꯅꯥ
কুইরক্লে	ꯀꯨꯏꯔꯛꯂꯦ
কুইরবনি	ꯀꯨꯏꯔꯕꯅꯤ
কুইরবা	ꯀꯨꯏꯔꯕꯥ
কুইরে	ꯀꯨꯏꯔꯦ
কুকি	ꯀꯨꯀꯤ
কুচু	ꯀꯨꯆꯨ
কুঞ্জ	ꯀꯨꯟꯖ
কুট	ꯀꯨꯇ
কুন	ꯀꯨꯅ
কুনদগী	ꯀꯨꯅꯗꯒꯤ
কুনমঙা	ꯀꯨꯅꯝꯉꯥ
কুন্থ্রা	ꯀꯨꯟꯊꯔꯥ
কুন্থ্রাগী	ꯀꯨꯟꯊꯔꯥꯒꯤ
কুন্দগী	ꯀꯨꯟꯗꯒꯤ
কুপশেন	ꯀꯨꯞꯁꯦꯟ
কুপ্তুনা	ꯀꯨꯞꯇꯨꯅꯥ
কুপ্না	ꯀꯨꯞꯅꯥ
কুপ্পা	ꯀꯨꯞꯄꯥ
কুম	ꯀꯨꯃ
কুমওন	ꯀꯨꯝꯑꯣꯟ
কুমওনগা	ꯀꯨꯝꯑꯣꯟꯒꯥ
কুমওনগী	ꯀꯨꯝꯑꯣꯟꯒꯤ
কুমওনবু	ꯀꯨꯝꯑꯣꯟꯕꯨ
কুমখি	ꯀꯨꯝꯈꯤ
কুমগী	ꯀꯨꯝꯒꯤ
কুমজা	ꯀꯨꯝꯖꯥ
কুমদুনা	ꯀꯨꯝꯗꯨꯅꯥ
কুমশি	ꯀꯨꯝꯁꯤ
কুমশিদি	ꯀꯨꯝꯁꯤꯗꯤ
কুমসি	ꯀꯨꯝꯁꯤ
কুমসিদি	ꯀꯨꯝꯁꯤꯗꯤ
কুমার	ꯀꯨꯃꯥꯔ
কুমারগী	ꯀꯨꯃꯥꯔꯒꯤ
কুমারজিৎনা	ꯀꯨꯃꯥꯔꯖꯤꯠꯅꯥ
কুমারনা	ꯀꯨꯃꯥꯔꯅꯥ
কুমারবু	ꯀꯨꯃꯥꯔꯕꯨ
কুমারী	ꯀꯨꯃꯥꯔꯤ
কুম্বা	ꯀꯨꯝꯕꯥ
কুম্বী	ꯀꯨꯝꯕꯤ
কুম্বীগী	ꯀꯨꯝꯕꯤꯒꯤ
কুম্মৈ	ꯀꯨꯝꯃꯩ
কুরু	ꯀꯨꯔꯨ
কুলাচন্দ্র	ꯀꯨꯂꯥꯆꯟꯗꯔ꯭
কুহ্মৈ	ꯀꯨꯍꯃꯩ
কুহ্মৈগা	ꯀꯨꯍꯃꯩꯒꯥ
কুহ্মৈগী	ꯀꯨꯍꯃꯩꯒꯤ
কুহ্মৈদা	ꯀꯨꯍꯃꯩꯗꯥ
কুহ্মৈনা	ꯀꯨꯍꯃꯩꯅꯥ
কুহ্মৈনি	ꯀꯨꯍꯃꯩꯅꯤ
কুহ্মৈবু	ꯀꯨꯍꯃꯩꯕꯨ
কুহ্মৈশিং	ꯀꯨꯍꯃꯩꯁꯤꯡ
কুহ্মৈশিংগী	ꯀꯨꯍꯃꯩꯁꯤꯡꯒꯤ
কুহ্মৈসু	ꯀꯨꯝꯍꯃꯩꯁꯨ
কৃক	ꯀꯔ꯭ꯤꯛ
কৃতিক	ꯀꯔ꯭ꯤꯇꯤꯛ
কৃষ্ণ	ꯀꯔ꯭ꯁꯅ
কৃষ্ণকুমার	ꯀꯔ꯭ꯤꯁꯅꯀꯨꯃꯥꯔ
কৃষ্ণকুমারনা	ꯀꯔ꯭ꯤꯁꯅꯀꯨꯃꯥꯔꯅꯥ
কৃষ্ণগী	ꯀꯔ꯭ꯤꯁꯅꯒꯤ
কৃষ্ণনগী	ꯀꯔ꯭ꯤꯁꯅꯅꯒꯤ
কৃষ্ণনা	ꯀꯔ꯭ꯤꯁꯅꯅꯥ
কৃষ্ণবু	ꯀꯔ꯭ꯤꯁꯅꯕꯨ
কে	ꯀꯦ
কেঐচ	ꯀꯦꯑꯩꯆ
কেজুয়েল	ꯀꯦꯖꯨꯌꯦꯜ
কেজ্রিৱাল	ꯀꯦꯖꯔꯤꯋꯥꯜ
কেজ্রিৱালনা	ꯀꯦꯖꯔꯤꯋꯥꯜꯅꯥ
কেটরিং	ꯀꯦꯇꯔꯤꯡ
কেদর	ꯀꯦꯗꯔ
কেদারনাথ	ꯀꯦꯗꯥꯔꯅꯥꯊ
কেদেটশিং	ꯀꯦꯗꯦꯇꯁꯤꯡ
কেন	ꯀꯦꯟ
কেনা	ꯀꯦꯅꯥ
কেনেদি	ꯀꯦꯅꯦꯗꯤ
কেনেল	ꯀꯦꯅꯦꯜ
কেন্দল	ꯀꯦꯟꯗꯜ
কেন্দিদেট	ꯀꯦꯟꯗꯤꯗꯦꯇ
কেন্দিদেটশিং	ꯀꯦꯟꯗꯤꯗꯦꯇꯁꯤꯡ
কেন্দিদেটশিংগী	ꯀꯦꯟꯗꯤꯗꯦꯇꯁꯤꯡꯒꯤ
কেন্দিদেটশিংদা	ꯀꯦꯟꯗꯤꯗꯦꯇꯁꯤꯡꯗꯥ
কেন্দিদেটশিংনা	ꯀꯦꯟꯗꯤꯗꯦꯇꯁꯤꯡꯅꯥ
কেন্দিদেত	ꯀꯦꯟꯗꯤꯗꯦꯇ
কেন্দিদেতশিং	ꯀꯦꯟꯗꯤꯗꯦꯇꯁꯤꯪ
কেন্দ্র	ꯀꯦꯟꯗꯔ꯭
কেন্দ্রগা	ꯀꯦꯟꯗꯔ꯭ꯒꯥ
কেন্দ্রগী	ꯀꯦꯟꯗꯔ꯭ꯒꯤ
কেন্দ্রদসু	ꯀꯦꯟꯗꯔ꯭ꯗꯁꯨ
কেন্দ্রদা	ꯀꯦꯟꯗꯔ꯭ꯗꯥ
কেন্দ্রনা	ꯀꯦꯟꯗꯔ꯭ꯅꯥ
কেন্দ্রশিং	ꯀꯦꯟꯗꯔ꯭ꯁꯤꯡ
কেন্দ্রশিংগী	ꯀꯦꯟꯗꯔ꯭ꯁꯤꯡꯒꯤ
কেন্দ্রশিংদগী	ꯀꯦꯟꯗꯔ꯭ꯁꯤꯡꯗꯒꯤ
কেন্দ্রশিংদা	ꯀꯦꯟꯗꯔ꯭ꯁꯤꯡꯗꯥ
কেন্দ্রসু	ꯀꯦꯟꯗꯔ꯭ꯁꯨ
কেন্দ্রিয়া	ꯀꯦꯟꯗꯔꯤꯌꯥ
কেন্সর	ꯀꯦꯟꯁꯔ
কেন্সেল	ꯀꯦꯟꯁꯦꯜ
কেপ	ꯀꯦꯞ
কেপতা	ꯀꯦꯞꯇꯥ
কেপসুল	ꯀꯦꯞꯁꯨꯜ
কেপিটেল	ꯀꯦꯄꯤꯇꯦꯜ
কেপ্টেন	ꯀꯦꯞꯇꯦꯅ
কেফ	ꯀꯦꯐ
কেবল	ꯀꯦꯕꯜ
কেবিদ	ꯀꯦꯕꯤꯗ
কেবিনা	ꯀꯦꯕꯤꯅꯥ
কেবিনেট	ꯀꯦꯕꯤꯅꯦꯇ
কেবিনেটকী	ꯀꯦꯕꯤꯅꯦꯇꯀꯤ
কেবিনেটতা	ꯀꯦꯕꯤꯅꯦꯇꯇꯥ
কেভি	ꯀꯦꯚꯤ
কেমিকেল	ꯀꯦꯃꯤꯀꯦꯜ
কেমেরা	ꯀꯦꯃꯦꯔꯥ
কেমেরাদা	ꯀꯦꯃꯦꯔꯥꯗꯥ
কেম্প	ꯀꯦꯝꯄ
কেম্পতা	ꯀꯦꯝꯄꯇꯥ
কেম্পশিং	ꯀꯦꯝꯄꯁꯤꯡ
কেম্পশিংদা	ꯀꯦꯝꯄꯁꯤꯪꯗꯥ
কেম্পস	ꯀꯦꯝꯄꯁ
কেম্পসতা	ꯀꯦꯝꯄꯁꯇꯥ
কেম্পসশিংদা	ꯀꯦꯝꯄꯁꯁꯤꯡꯗꯥ
কেম্পেইন	ꯀꯦꯝꯄꯦꯏꯟ
কেম্পেইনগী	ꯀꯦꯝꯄꯦꯏꯟꯒꯤ
কেম্পেইনদা	ꯀꯦꯝꯄꯦꯏꯟꯗꯥ
কেম্পেইনশিংদা	ꯀꯦꯝꯄꯦꯏꯟꯁꯤꯡꯗꯥ
কেম্পেন	ꯀꯦꯝꯄꯦꯟ
কেম্পেনবু	ꯀꯦꯝꯄꯦꯟꯕꯨ
কেরলা	ꯀꯦꯔꯂꯥ
কেরলাগী	ꯀꯦꯔꯂꯥꯒꯤ
কেরলাদা	ꯀꯦꯔꯂꯥꯗꯥ
কেরলানা	ꯀꯦꯔꯂꯥꯅꯥ
কেরি	ꯀꯦꯔꯤ
কেরিয়র	ꯀꯦꯔꯤꯌꯔ
কেরিয়রগী	ꯀꯦꯔꯤꯌꯔꯒꯤ
কেরিয়রদা	ꯀꯦꯔꯤꯌꯔꯗꯥ
কেরিয়ার	ꯀꯦꯔꯤꯌꯥꯔ
কেলেন্দর	ꯀꯦꯂꯦꯟꯗꯔ
কেলেন্দরগী	ꯀꯦꯂꯦꯟꯗꯔꯒꯤ
কেস	ꯀꯦꯁ
কেসকা	ꯀꯦꯁꯀꯥ
কেসকি	ꯀꯦꯁꯀꯤ
কেসকী	ꯀꯦꯁꯀꯤ
কেসতা	ꯀꯦꯁꯇꯥ
কেসনা	ꯀꯦꯁꯅꯥ
কেসনি	ꯀꯦꯁꯅꯤ
কেসশিং	ꯀꯦꯁꯁꯤꯡ
কেসশিংগী	ꯀꯦꯁꯁꯤꯡꯒꯤ
কেসশিংদা	ꯀꯦꯁꯁꯤꯡꯗꯥ
কেসসু	ꯀꯦꯁꯁꯨ
কেয়র	ꯀꯦꯌꯔ
কেয়ার	ꯀꯦꯌꯥꯔ
কৈ	ꯀꯩ
কৈওইবা	ꯀꯩꯑꯣꯏꯕꯥ
কৈগা	ꯀꯩꯒꯥ
কৈগুম্না	ꯀꯩꯒꯨꯝꯅꯥ
কৈথেল	ꯀꯩꯊꯦꯜ
কৈথেলগী	ꯀꯩꯊꯦꯜꯒꯤ
কৈথেলদগী	ꯀꯩꯊꯦꯜꯗꯒꯤ
কৈথেলদা	ꯀꯩꯊꯦꯜꯗꯥ
কৈথেলনচিংবা	ꯀꯩꯊꯦꯜꯅꯆꯤꯡꯕꯥ
কৈথেলনা	ꯀꯩꯊꯦꯜꯅꯥ
কৈথেলমানবী	ꯀꯩꯊꯦꯜꯃꯥꯟꯕꯤ
কৈথেলশিং	ꯀꯩꯊꯦꯜꯁꯤꯡ
কৈথেলশিংগী	ꯀꯩꯊꯦꯜꯁꯤꯡꯒꯤ
কৈথেলশিংদা	ꯀꯩꯊꯦꯜꯁꯤꯡꯗꯥ
কৈথেলশিংদি	ꯀꯩꯊꯦꯜꯁꯤꯡꯗꯤ
কৈথেলশিংনা	ꯀꯩꯊꯦꯜꯁꯤꯡꯅꯥ
কৈথেলশিংসু	ꯀꯩꯊꯦꯜꯁꯤꯡꯁꯨ
কৈদসু	ꯀꯩꯗꯁꯨ
কৈদা	ꯀꯩꯗꯥ
কৈনা	ꯀꯩꯅꯥ
কৈবুল	ꯀꯩꯕꯨꯜ
কৈরাও	ꯀꯩꯔꯥꯎ
কৈরাক	ꯀꯩꯔꯥꯛ
কৈশাম	ꯀꯩꯁꯥꯝ
কৈশামপাৎ	ꯀꯩꯁꯥꯝꯄꯥꯠ
কৈশাম্পাৎ	ꯀꯩꯁꯥꯝꯄꯥꯠ
কৈশাম্পাৎতা	ꯀꯩꯁꯥꯝꯄꯥꯠꯇꯥ
কৈসাম	ꯀꯩꯁꯥꯝ
ক্বা	ꯀ꯭ꯋꯥ
ক্বাক	ꯀ꯭ꯋꯥꯛ
ক্বাকৈথেল	ꯀ꯭ꯋꯥꯀꯩꯊꯦꯜ
ক্বাকৈথেলগী	ꯀ꯭ꯋꯥꯀꯩꯊꯦꯜꯒꯤ
ক্বাকৈথেলদা	ꯀ꯭ꯋꯥꯀꯩꯊꯦꯜꯗ
ক্বাগী	ꯀ꯭ꯋꯥꯒꯤ
ক্বাটর	ꯀ꯭ꯋꯥꯇꯔ
ক্বাটরদা	ꯀ꯭ꯋꯥꯇꯔꯗ
ক্বাটরশিং	ꯀ꯭ꯋꯥꯇꯔꯁꯤꯡ
ক্বাথাদা	ꯀ꯭ꯋꯥꯊꯥꯗ
ক্বাদ	ꯀ꯭ꯋꯥꯗ
ক্বারিন্টিন	ꯀ꯭ꯋꯥꯔꯤꯟꯇꯤꯟ
ক্বারেন্টাইন	ꯀ꯭ꯋꯥꯔꯦꯟꯇꯥꯏꯟ
ক্বারেন্টিন	ꯀ꯭ꯋꯥꯔꯦꯟꯇꯤꯟ
ক্বারেন্টিনদা	ꯀ꯭ꯋꯥꯔꯦꯟꯇꯤꯟꯗ
ক্বালিটি	ꯀ꯭ꯋꯥꯂꯤꯇꯤ
ক্বালিফাই	ꯀ꯭ꯋꯥꯂꯤꯐꯥꯢ
ক্বালিফাইদ	ꯀ꯭ꯋꯥꯂꯤꯐꯥꯢꯗ
ক্বিট	ꯀ꯭ꯋꯤꯠ
ক্বিন	ꯀ꯭ꯋꯤꯟ
ক্বেসন	ꯀ꯭ꯋꯦꯁꯟ
ক্যু	ꯀ꯭ꯌꯨ
ক্লব	ꯀ꯭ꯂꯕ
ক্লবকা	ꯀ꯭ꯂꯕꯀ
ক্লবকী	ꯀ꯭ꯂꯕꯀꯤ
ক্লবতা	ꯀ꯭ꯂꯕꯇ
ক্লবনা	ꯀ꯭ꯂꯕꯅ
ক্লবপু	ꯀ꯭ꯂꯕꯄꯨ
ক্লবশিং	ꯀ꯭ꯂꯕꯁꯤꯡ
ক্লবশিংগী	ꯀ꯭ꯂꯕꯁꯤꯡꯒꯤ
ক্লবশিংদা	ꯀ꯭ꯂꯕꯁꯤꯡꯗ
ক্লবশিংনা	ꯀ꯭ꯂꯕꯁꯤꯡꯅ
ক্লষ্টর	ꯀ꯭ꯂꯁꯇ꯭ꯔ
ক্লাইমেট	ꯀ꯭ꯂꯥꯢꯃꯦꯠ
ক্লাইম্বিং	ꯀ꯭ꯂꯥꯏꯝꯕꯤꯡ
ক্লাস	ꯀ꯭ꯂꯥꯁ
ক্লাসকী	ꯀ꯭ꯂꯥꯁꯀꯤ
ক্লাসতা	ꯀ꯭ꯂꯥꯁꯇ
ক্লাসশিং	ꯀ꯭ꯂꯥꯁꯁꯤꯡ
ক্লাসা	ꯀ꯭ꯂꯥꯁꯥ
ক্লাসিক	ꯀ꯭ꯂꯥꯁꯤꯛ
ক্লিন	ꯀ꯭ꯂꯤꯟ
ক্লিনিক	ꯀ꯭ꯂꯤꯅꯤꯛ
ক্লিনিকশিং	ꯀ꯭ꯂꯤꯅꯤꯛꯁꯤꯡ
ক্লিনিকেল	ꯀ꯭ꯂꯤꯅꯤꯀꯦꯜ
ক্লে	ꯀ꯭ꯂꯦ
ক্লেইম	ꯛꯂꯦꯏꯝ
ক্লেম	ꯀ꯭ꯂꯦꯝ
কৎখ্রবা	ꯀꯠꯈ꯭ꯔꯕ
কৎখ্রে	ꯀꯠꯈ꯭ꯔꯦ
কৎতুনা	ꯀꯠꯇꯨꯅ
কৎপগা	ꯀꯠꯄꯒ
কৎপগী	ꯀꯠꯄꯒꯤ
কৎপা	ꯀꯠꯄ
কৎলবা	ꯀꯠꯂꯕ
কৎলি	ꯀꯠꯂꯤ
কয়া	ꯀꯌꯥ
কয়াগসু	ꯀꯌꯥꯒꯁꯨ
কয়াগা	ꯀꯌꯥꯒ
কয়াগী	ꯀꯌꯥꯒꯤ
কয়াদগী	ꯀꯌꯥꯗꯒꯤ
কয়াদসু	ꯀꯌꯥꯗꯁꯨ
কয়াদা	ꯀꯌꯥꯗ
কয়াদি	ꯀꯌꯥꯗꯤ
কয়াদু	ꯀꯌꯥꯗꯨ
কয়াদুগী	ꯀꯌꯥꯗꯨꯒꯤ
কয়াদুনা	ꯀꯌꯥꯗꯨꯅ
কয়ানসু	ꯀꯌꯥꯅꯁꯨ
কয়ানা	ꯀꯌꯥꯅ
কয়ানি	ꯀꯌꯥꯅꯤ
কয়াবু	ꯀꯌꯥꯕꯨ
কয়াম	ꯀꯌꯥꯝ
কয়ামরুম	ꯀꯌꯥꯃꯔꯨꯝ
কয়ামরুমগী	ꯀꯌꯥꯃꯔꯨꯝꯒꯤ
কয়ামরুমদা	ꯀꯌꯥꯃꯔꯨꯝꯗ
কয়ামরুমসু	ꯀꯌꯥꯃꯔꯨꯝꯁꯨ
কয়ামুক	ꯀꯌꯥꯃꯨꯛ
কয়ারক	ꯀꯌꯥꯔꯛ
কয়াশিং	ꯀꯌꯥꯁꯤꯡ
কয়াসি	ꯀꯌꯥꯁꯤ
কয়াসু	ꯀꯌꯥꯁꯨ
কয়াৎ	ꯀꯌꯥꯠ
খংখি	ꯈꯪꯈꯤ
খংথা	ꯈꯪꯊꯥ
খংদনা	ꯈꯪꯗꯅ
খংদ্রি	ꯈꯪꯗ꯭ꯔꯤ
খংন	ꯈꯪꯅ
খংনবা	ꯈꯪꯅꯕ
খংনরিবা	ꯈꯪꯅꯔꯤꯕ
খংনা	ꯈꯪꯅ
খংবা	ꯈꯪꯕ
খংমিন্নসি	ꯈꯪꯃꯤꯟꯅꯁꯤ
খংলবা	ꯈꯪꯂꯕ
খংহেন	ꯈꯪꯍꯦꯟ
খংৱাং	ꯈꯪꯋꯥꯡ
খক	ꯈꯛ
খক্কী	ꯈꯛꯀꯤ
খঙ	ꯈꯡ
খঙই	ꯈꯡꯏ
খঙখিদে	ꯈꯡꯈꯤꯗꯦ
খঙগদবনি	ꯈꯡꯒꯗꯕꯅꯤ
খঙগনি	ꯈꯡꯒꯅꯤ
খঙগে	ꯈꯡꯒꯦ
খঙজিনবা	ꯈꯡꯖꯤꯟꯕ
খঙদনা	ꯈꯡꯗꯅꯥ
খঙদবনা	ꯈꯡꯗꯕꯅ
খঙদবা	ꯈꯡꯗꯕ
খঙদুনা	ꯈꯡꯗꯨꯅ
খঙদে	ꯈꯡꯗꯦ
খঙদ্রবা	ꯈꯡꯗ꯭ꯔꯕ
খঙদ্রি	ꯈꯡꯗ꯭ꯔꯤ
খঙদ্রিবা	ꯈꯡꯗ꯭ꯔꯤꯕ
খঙনগনি	ꯈꯡꯅꯒꯅꯤ
খঙনবগা	ꯈꯡꯅꯕꯒ
খঙনবা	ꯈꯡꯅꯕ
খঙনবী	ꯈꯡꯅꯕꯤ
খঙনরকপদগী	ꯈꯡꯅꯔꯛꯄꯗꯒꯤ
খঙনরকপা	ꯈꯡꯅꯔꯛꯄ
খঙনরক্লবা	ꯈꯉꯅꯔꯛꯂꯕ
খঙনরবা	ꯈꯡꯅꯔꯕ
খঙনরম্বনি	ꯈꯡꯅꯔꯝꯕꯅꯤ
খঙনরম্বা	ꯈꯡꯅꯔꯝꯕ
খঙনরিবনি	ꯈꯡꯅꯔꯤꯕꯅꯤ
খঙনরিবা	ꯈꯡꯅꯔꯤꯕ
খঙনা	ꯈꯡꯅ
খঙনিংই	ꯈꯡꯅꯤꯡꯏ
খঙনিংবা	ꯈꯡꯅꯤꯡꯕ
খঙনৈ	ꯈꯡꯅꯩ
খঙবগা	ꯈꯡꯕꯒ
খঙবগী	ꯈꯡꯕꯒꯤ
খঙবদগী	ꯈꯡꯕꯗꯒꯤ
খঙবসু	ꯈꯡꯕꯁꯨ
খঙবা	ꯈꯡꯕ
খঙবিবা	ꯈꯡꯕꯤꯕ
খঙবীদুনা	ꯈꯡꯕꯤꯗꯨꯅ
খঙমিন্ননবা	ꯈꯡꯃꯤꯟꯅꯅꯕ
খঙলকখিবনি	ꯈꯡꯂꯛꯈꯤꯕꯅꯤ
খঙলগা	ꯈꯡꯂꯒ
খঙলবদি	ꯈꯡꯂꯕꯗꯤ
খঙলবা	ꯈꯡꯂꯕ
খঙলি	ꯈꯡꯂꯤ
খঙলে	ꯈꯡꯂꯦ
খঙহনখি	ꯈꯡꯍꯟꯈꯤ
খঙহনখিবগী	ꯈꯡꯍꯟꯈꯤꯕꯒꯤ
খঙহনখিবনি	ꯈꯡꯍꯟꯈꯤꯕꯅꯤ
খঙহনখিবা	ꯈꯡꯍꯟꯈꯤꯕ
খঙহনখ্রবনি	ꯈꯡꯍꯟꯈ꯭ꯔꯕꯅꯤ
খঙহনখ্রে	ꯈꯡꯍꯟꯈ꯭ꯔꯦ
খঙহনগদবনি	ꯈꯡꯍꯟꯒꯗꯕꯅꯤ
খঙহনবগা	ꯈꯡꯍꯟꯕꯒꯥ
খঙহনবগী	ꯈꯡꯍꯟꯕꯒꯤ
খঙহনবদা	ꯈꯡꯍꯟꯕꯗ
খঙহনবা	ꯈꯡꯍꯟꯕ
খঙহনবীয়ু	ꯈꯡꯍꯟꯕꯤꯌꯨ
খঙহন্দনা	ꯈꯡꯍꯟꯗꯅ
খঙহন্দুনা	ꯈꯡꯍꯟꯗꯨꯅ
খঙহন্নবগী	ꯈꯡꯍꯟꯅꯕꯒꯤ
খঙহন্নবা	ꯈꯡꯍꯟꯅꯕ
খঙহল্লকখি	ꯈꯡꯍꯜꯂꯛꯈꯤ
খঙহল্লকখিবা	ꯈꯡꯍꯜꯂꯛꯈꯤꯕ
খঙহল্লকখ্রে	ꯈꯡꯍꯜꯂꯛꯈ꯭ꯔꯦ
খঙহল্লকপগী	ꯈꯡꯍꯜꯂꯛꯄꯒꯤ
খঙহল্লকপা	ꯈꯡꯍꯜꯂꯛꯄ
খঙহল্লক্নবসু	ꯈꯡꯍꯜꯂꯛꯅꯕꯁꯨ
খঙহল্লক্নবা	ꯈꯡꯍꯜꯂꯛꯅꯕ
খঙহল্লক্লি	ꯈꯡꯍꯜꯂꯛꯂꯤ
খঙহল্লক্লে	ꯈꯡꯍꯜꯂꯛꯂꯦ
খঙহল্লগনি	ꯈꯡꯍꯜꯂꯒꯅꯤ
খঙহল্লবসু	ꯈꯡꯍꯜꯂꯕꯁꯨ
খঙহল্লি	ꯈꯡꯍꯜꯂꯤ
খঙহেন	ꯈꯡꯍꯦꯟ
খঞ্জবা	ꯈꯟꯖꯕ
খনখি	ꯈꯟꯈꯤ
খনখিবগা	ꯈꯟꯈꯤꯕꯒ
খনখিবনি	ꯈꯟꯈꯤꯕꯅꯤ
খনখিবা	ꯈꯟꯈꯤꯕ
খনখ্রবা	ꯈꯟꯈ꯭ꯔꯕ
খনখ্রে	ꯈꯟꯈ꯭ꯔꯦ
খনগদবনি	ꯈꯟꯒꯗꯕꯅꯤ
খনগদবা	ꯈꯟꯒꯗꯕ
খনগনি	ꯈꯟꯒꯅꯤ
খনগৎকনি	ꯈꯟꯒꯠꯀꯅꯤ
খনগৎতুনা	ꯈꯟꯒꯠꯇꯨꯅ
খনগৎপদা	ꯈꯟꯒꯠꯄꯗ
খনগৎপা	ꯈꯟꯒꯠꯄ
খনগৎলবা	ꯈꯟꯒꯠꯂꯕ
খনদ্রিবা	ꯈꯟꯗ꯭ꯔꯤꯕ
খনবগা	ꯈꯟꯕꯒ
খনবগী	ꯈꯟꯕꯒꯤ
খনবদগী	ꯈꯟꯕꯗꯒꯤ
খনবদা	ꯈꯟꯕꯗ
খনবা	ꯈꯟꯕ
খনবীবা	ꯈꯟꯕꯤꯕ
খন্থগদবনি	ꯈꯟꯊꯒꯗꯕꯅꯤ
খন্থদনা	ꯈꯟꯊꯗꯅꯥ
খন্থদুনা	ꯈꯟꯊꯗꯨꯅ
খন্থবা	ꯈꯟꯊꯕ
খন্দনা	ꯈꯟꯗꯅ
খন্দবা	ꯈꯟꯗꯕ
খন্দুনতা	ꯈꯟꯗꯨꯅꯇꯥ
খন্দুনা	ꯈꯟꯗꯨꯅ
খন্দে	ꯈꯟꯗꯦ
খন্ন	ꯈꯟꯅ
খন্নখি	ꯈꯟꯅꯈꯤ
খন্নখিগনি	ꯈꯟꯅꯈꯤꯒꯅꯤ
খন্নখিবনি	ꯈꯟꯅꯈꯤꯕꯅꯤ
খন্নখিবা	ꯈꯟꯅꯈꯤꯕ
খন্নখ্রে	ꯈꯟꯅꯈ꯭ꯔꯦ
খন্নগদবনি	ꯈꯟꯅꯒꯗꯕꯅꯤ
খন্নগদবা	ꯈꯟꯅꯒꯗꯕ
খন্নগনি	ꯈꯟꯅꯒꯅꯤ
খন্নদবা	ꯈꯟꯅꯗꯕꯥ
খন্নদুনা	ꯈꯟꯅꯗꯨꯅ
খন্ননবগী	ꯈꯟꯅꯅꯕꯒꯤ
খন্ননবা	ꯈꯟꯅꯅꯕ
খন্নফম	ꯈꯟꯅꯐꯝ
খন্নবগা	ꯈꯟꯅꯕꯒ
খন্নবগী	ꯈꯟꯅꯕꯒꯤ
খন্নবগীদমক	ꯈꯟꯅꯕꯒꯤꯗꯃꯛ
খন্নবদা	ꯈꯟꯅꯕꯗ
খন্নবা	ꯈꯟꯅꯕ
খন্নরকপদা	ꯈꯟꯅꯔꯛꯄꯗ
খন্নরগনি	ꯈꯟꯅꯔꯒꯅꯤ
খন্নরগা	ꯈꯟꯅꯔꯒ
খন্নরবা	ꯈꯟꯅꯔꯕ
খন্নরম্বা	ꯈꯟꯅꯔꯝꯕ
খন্নরি	ꯈꯟꯅꯔꯤ
খন্নরিবা	ꯈꯟꯅꯔꯤꯕ
খন্নরে	ꯈꯟꯅꯔꯦ
খন্নসি	ꯈꯟꯅꯁꯤ
খন্না	ꯈꯟꯅ
খন্নৈ	ꯈꯟꯅꯩ
খম	ꯈꯝ
খমথেংনা	ꯈꯝꯊꯦꯡꯅ
খম্বা	ꯈꯝꯕꯥ
খর	ꯈꯔ
খরখক	ꯈꯔꯈꯛ
খরগা	ꯈꯔꯒ
খরগী	ꯈꯔꯒꯤ
খরগীনা	ꯈꯔꯒꯤꯅ
খরগীসু	ꯈꯔꯒꯤꯁꯨ
খরচ	ꯈꯔꯆ
খরদং	ꯈꯔꯗꯪ
খরদংগী	ꯈꯔꯗꯪꯒꯤ
খরদগী	ꯈꯔꯗꯒꯤ
খরদদি	ꯈꯔꯗꯗꯤ
খরদনা	ꯈꯔꯗꯅ
খরদসু	ꯈꯔꯗꯁꯨ
খরদা	ꯈꯔꯗ
খরদি	ꯈꯔꯗꯤ
খরদু	ꯈꯔꯗꯨ
খরদুনা	ꯈꯔꯗꯨꯅꯥ
খরনদি	ꯈꯔꯅꯗꯤ
খরনা	ꯈꯔꯅ
খরনি	ꯈꯔꯅꯤ
খরনিগী	ꯈꯔꯅꯤꯒꯤ
খরনিদা	ꯈꯔꯅꯤꯗ
খরনিসিদা	ꯈꯔꯅꯤꯁꯤꯗ
খরমখৈ	ꯈꯔꯃꯈꯩ
খরমখৈদি	ꯈꯔꯃꯈꯩꯗꯤ
খরসি	ꯈꯔꯁꯤ
খরসিগী	ꯈꯔꯁꯤꯒꯤ
খরসিদা	ꯈꯔꯁꯤꯗ
খরসু	ꯈꯔꯁꯨ
খরা	ꯈꯔꯥ
খরানা	ꯈꯔꯥꯅ
খল	ꯈꯜ
খলহল্লি	ꯈꯜꯍꯜꯂꯤ
খল্লকখিবনি	ꯈꯜꯂꯛꯈꯤꯕꯅꯤ
খল্লকখিবা	ꯈꯜꯂꯛꯈꯤꯕ
খল্লকপদা	ꯈꯜꯂꯛꯄꯗ
খল্লকপা	ꯈꯜꯂꯛꯄ
খল্লক্লে	ꯈꯜꯂꯛꯂꯦ
খল্লগা	ꯈꯜꯂꯒ
খল্লবদি	ꯈꯜꯂꯕꯗꯤ
খল্লবা	ꯈꯜꯂꯕ
খল্লম্বদু	ꯈꯜꯂꯝꯕꯗꯨ
খল্লসি	ꯈꯜꯂꯁꯤ
খল্লি	ꯈꯜꯂꯤ
খল্লিবসি	ꯈꯜꯂꯤꯕꯁꯤ
খল্লিবা	ꯈꯜꯂꯤꯕ
খল্লুদনা	ꯈꯜꯂꯨꯗꯅ
খল্লুদে	ꯈꯜꯂꯨꯗꯦ
খল্লুনু	ꯈꯜꯂꯨꯅꯨ
খল্লুবদা	ꯈꯜꯂꯨꯕꯗꯥ
খল্লুরগা	ꯈꯜꯂꯨꯔꯒꯥ
খল্লে	ꯈꯜꯂꯦ
খা	ꯈꯥ
খাং	ꯈꯥꯪ
খাংদুনা	ꯈꯥꯡꯗꯨꯅ
খাংবা	ꯈꯥꯡꯕ
খাইদেম	ꯈꯥꯢꯗꯦꯝ
খাইনা	ꯈꯥꯢꯅ
খাইবা	ꯈꯥꯢꯕ
খাইবুং	ꯈꯥꯢꯕꯨꯡ
খাক্না	ꯈꯥꯛꯅꯥ
খাক্লি	ꯈꯥꯛꯂꯤ
খাঙদুনা	ꯈꯥꯡꯗꯨꯅ
খাঙবগী	ꯈꯥꯡꯕꯒꯤ
খাঙবা	ꯈꯥꯡꯕ
খাঙেনবম	ꯈꯥꯉꯦꯟꯕꯝ
খাঙেম্বম	ꯈꯥꯉꯦꯝꯕꯝ
খাজনা	ꯈꯥꯖꯅꯥ
খাদা	ꯈꯥꯗ
খাদি	ꯈꯥꯗꯤ
খাদিগী	ꯈꯥꯗꯤꯒꯤ
খাদিনা	ꯈꯥꯗꯤꯅ
খান	ꯈꯥꯟ
খাননা	ꯈꯥꯅꯅ
খান্না	ꯈꯥꯟꯅ
খাবগী	ꯈꯥꯕꯒꯤ
খাবম	ꯈꯥꯕꯝ
খামদুনা	ꯈꯥꯃꯗꯨꯅ
খাম্নবা	ꯈꯥꯝꯅꯕ
খাম্বা	ꯈꯥꯝꯕ
খাম্লগা	ꯈꯥꯝꯂꯒꯥ
খাম্লুবদা	ꯈꯥꯝꯂꯨꯕꯗ
খারম	ꯈꯥꯔꯝ
খারিবা	ꯈꯥꯔꯤꯕ
খাশি	ꯈꯥꯁꯤ
খাসি	ꯈꯥꯁꯤ
খাসিম	ꯈꯥꯁꯤꯝ
খায়দনা	ꯈꯥꯢꯗꯅ
খায়দবা	ꯈꯥꯢꯗꯕ
খায়না	ꯈꯥꯢꯅ
খায়বগী	ꯈꯥꯢꯕꯒꯤ
খায়বা	ꯈꯥꯢꯕ
খি	ꯈꯤ
খিল্লিবা	ꯈꯤꯜꯂꯤꯕ
খুঙ্গং	ꯈꯨꯡꯒꯪ
খুঙ্গংগা	ꯈꯨꯡꯒꯪꯒ
খুঙ্গংগী	ꯈꯨꯡꯒꯪꯒꯤ
খুঙ্গংদগী	ꯈꯨꯡꯒꯪꯗꯒꯤ
খুঙ্গংদা	ꯈꯨꯡꯒꯪꯗ
খুঙ্গংশিং	ꯈꯨꯡꯒꯪꯁꯤꯡ
খুঙ্গংশিংদা	ꯈꯨꯡꯒꯪꯁꯤꯡꯗ
খুজি	ꯈꯨꯖꯤ
খুজিং	ꯈꯨꯖꯤꯡ
খুজিল	ꯈꯨꯖꯤꯜ
খুজেং	ꯈꯨꯖꯦꯪ
খুঞ্জা	ꯈꯨꯟꯖ
খুঞ্জাশিং	ꯈꯨꯟꯖꯥꯁꯤꯡ
খুঞ্জাশিংগী	ꯈꯨꯟꯖꯥꯁꯤꯡꯒꯤ
খুঞ্জাশিংগীদমক	ꯈꯨꯟꯖꯥꯁꯤꯡꯒꯤꯗꯃꯛ
খুঞ্জাশিংদা	ꯈꯨꯟꯖꯥꯁꯤꯡꯗ
খুঞ্জাশিংনা	ꯈꯨꯟꯖꯥꯁꯤꯡꯅ
খুত্থাংদা	ꯈꯨꯠꯊꯥꯡꯗ
খুদক	ꯈꯨꯗꯛ
খুদক্কী	ꯈꯨꯗꯛꯀꯤ
খুদম	ꯈꯨꯗꯝ
খুদমনি	ꯈꯨꯗꯝꯅꯤ
খুদিং	ꯈꯨꯗꯤꯡ
খুদিংগী	ꯈꯨꯗꯤꯡꯒꯤ
খুদিংদগী	ꯈꯨꯗꯤꯡꯗꯒꯤ
খুদিংদা	ꯈꯨꯗꯤꯡꯗ
খুদিংমক	ꯈꯨꯗꯤꯡꯃꯛ
খুদিংমকপু	ꯈꯨꯗꯤꯡꯃꯛꯄꯨ
খুদিংমক্কী	ꯈꯨꯗꯤꯡꯃꯛꯀꯤ
খুদিংমক্না	ꯈꯨꯗꯤꯡꯃꯛꯅ
খুদুং	ꯈꯨꯗꯨꯡ
খুদুনা	ꯈꯨꯗꯨꯅ
খুদুম	ꯈꯨꯗꯨꯝ
খুদৈ	ꯈꯨꯗꯩ
খুন	ꯈꯨꯅ
খুনগা	ꯈꯨꯅꯒꯥ
খুনগী	ꯈꯨꯅꯒꯤ
খুনবা	ꯈꯨꯅꯕ
খুনাই	ꯈꯨꯅꯥꯏ
খুনাইগী	ꯈꯨꯅꯥꯢꯒꯤ
খুনিংথেক	ꯈꯨꯅꯤꯡꯊꯦꯛ
খুনু	ꯈꯨꯅꯨ
খুনুং	ꯈꯨꯅꯨꯡ
খুন্তাকপা	ꯈꯨꯟꯇꯥꯛꯄ
খুন্দা	ꯈꯨꯟꯗ
খুন্দাদুনা	ꯈꯨꯟꯗꯥꯗꯨꯅꯥ
খুন্দাবা	ꯈꯨꯟꯗꯥꯕ
খুন্দামিন্নরিবা	ꯈꯨꯟꯗꯥꯃꯤꯟꯅꯔꯤꯕ
খুন্দারিবা	ꯈꯨꯟꯗꯥꯔꯤꯕ
খুন্দ্রাকপম	ꯈꯨꯟꯗ꯭ꯔꯥꯛꯄꯝ
খুন্নাই	ꯈꯨꯟꯅꯥꯢ
খুন্নাইগা	ꯈꯨꯟꯅꯥꯢꯒ
খুন্নাইগী	ꯈꯨꯟꯅꯥꯢꯒꯤ
খুন্নাইগীদমক	ꯈꯨꯟꯅꯥꯢꯒꯤꯗꯃꯛ
খুন্নাইদা	ꯈꯨꯟꯅꯥꯢꯗ
খুন্নাইনা	ꯈꯨꯟꯅꯥꯢꯅ
খুন্নাইবু	ꯈꯨꯟꯅꯥꯢꯕꯨ
খুবম	ꯈꯨꯕꯝ
খুবা	ꯈꯨꯕ
খুবাক	ꯈꯨꯕꯥꯛ
খুবাম	ꯈꯨꯕꯥꯃ
খুবৈ	ꯈꯨꯕꯩ
খুভম	ꯈꯨꯚꯝ
খুভমদা	ꯈꯨꯚꯝꯗ
খুমন	ꯈꯨꯃꯟ
খুমনবু	ꯈꯨꯃꯟꯕꯨ
খুমন্থেম	ꯈꯨꯃꯟꯊꯦꯝ
খুমন্না	ꯈꯨꯃꯟꯅꯥ
খুমাং	ꯈꯨꯃꯥꯡ
খুমুকচম	ꯈꯨꯃꯨꯛꯆꯝ
খুম্নখি	ꯈꯨꯝꯅꯈꯤ
খুম্নখ্রবা	ꯈꯨꯝꯅꯈ꯭ꯔꯕ
খুম্নগদবনি	ꯈꯨꯝꯅꯒꯗꯕꯅꯤ
খুম্নদুনা	ꯈꯨꯝꯅꯗꯨꯅ
খুম্ননা	ꯈꯨꯝꯅꯅ
খুম্ননিংঙাই	ꯈꯨꯝꯅꯅꯤꯡꯉꯥꯢ
খুম্নফম	ꯈꯨꯝꯅꯐꯝ
খুম্নবা	ꯈꯨꯝꯅꯕ
খুম্নৈ	ꯈꯨꯝꯅꯩ
খুম্বগী	ꯈꯨꯝꯕꯒꯤ
খুম্বা	ꯈꯨꯝꯕꯥ
খুম্লকই	ꯈꯨꯝꯂꯛꯏ
খুরম্বা	ꯈꯨꯔꯝꯕ
খুরা	ꯈꯨꯔꯥ
খুরাই	ꯈꯨꯔꯥꯢ
খুরাইজম	ꯈꯨꯔꯥꯢꯖꯝ
খুরুমজরি	ꯈꯨꯔꯨꯝꯖꯔꯤ
খুরুমজৈ	ꯈꯨꯔꯨꯝꯖꯩ
খুরুমদুনা	ꯈꯨꯔꯨꯝꯗꯨꯅ
খুরুম্নবা	ꯈꯨꯔꯨꯝꯅꯕꯥ
খুরুম্বা	ꯈꯨꯔꯨꯝꯕ
খুরুম্লগা	ꯈꯨꯔꯨꯝꯂꯒꯥ
খুল	ꯈꯨꯜ
খুলগী	ꯈꯨꯜꯒꯤ
খুলদগীনি	ꯈꯨꯜꯗꯒꯤꯅꯤ
খুলদা	ꯈꯨꯜꯗ
খুলনা	ꯈꯨꯜꯅ
খুলশিংগী	ꯈꯨꯜꯁꯤꯡꯒꯤ
খুল্লবা	ꯈꯨꯜꯂꯕ
খুল্লাকপগী	ꯈꯨꯜꯂꯥꯛꯄꯒꯤ
খুল্লেন	ꯈꯨꯜꯂꯦꯟ
খুল্লেনদা	ꯈꯨꯜꯂꯦꯟꯗ
খুৎ	ꯈꯨꯠ
খুৎতা	ꯈꯨꯠꯇ
খুৎথা	ꯈꯨꯠꯊꯥ
খুৎনা	ꯈꯨꯠꯅ
খুৎপু	ꯈꯨꯠꯄꯨ
খুৎপুনা	ꯈꯨꯠꯄꯨꯅ
খুৎলাই	ꯈꯨꯠꯂꯥꯢ
খুৎলায়	ꯈꯨꯠꯂꯥꯢ
খুৎলায়শিং	ꯈꯨꯠꯂꯥꯢꯁꯤꯡ
খুৎশম্নদুনা	ꯈꯨꯠꯁꯝꯅꯗꯨꯅ
খুৎশম্ননা	ꯈꯨꯠꯁꯝꯅꯅ
খুৎশম্নরগা	ꯈꯨꯠꯁꯝꯅꯔꯒ
খুৎশা	ꯈꯨꯠꯁꯥ
খুৎশিন্নখি	ꯈꯨꯠꯁꯤꯟꯅꯈꯤ
খুৎশিন্নখিবনি	ꯈꯨꯠꯁꯤꯟꯅꯈꯤꯕꯅꯤ
খুৎশিন্নখ্রে	ꯈꯨꯠꯁꯤꯟꯅꯈ꯭ꯔꯦ
খুৎশিন্নদ্রিঙৈ	ꯈꯨꯠꯁꯤꯟꯅꯗ꯭ꯔꯤꯉꯩ
খুৎশিন্নবগী	ꯈꯨꯠꯁꯤꯟꯅꯕꯒꯤ
খুৎশিন্নবা	ꯈꯨꯠꯁꯤꯟꯅꯕ
খুৎশু	ꯈꯨꯠꯁꯨ
খুৎশুমন	ꯈꯨꯠꯁꯨꯃꯟ
খুৎশুমল	ꯈꯨꯠꯁꯨꯃꯜ
খুৎশেমগী	ꯈꯨꯠꯁꯦꯝꯒꯤ
খুৎহৈবা	ꯈꯨꯠꯍꯩꯕ
খুয়া	ꯈꯨꯌꯥ
খূদিং	ꯈꯨꯗꯤꯪ
খূদিংগী	ꯈꯨꯗꯤꯪꯒꯤ
খূদিংনা	ꯈꯨꯗꯤꯪꯅꯥ
খূদিংমক	ꯈꯨꯗꯤꯪꯃꯛ
খৃষ্ট	ꯈ꯭ꯔꯤꯁꯇ
খৃষ্টকী	ꯈ꯭ꯔꯤꯁꯇꯀꯤ
খৃষ্টগী	ꯈ꯭ꯔꯤꯁꯇꯒꯤ
খৃষ্টতগী	ꯈ꯭ꯔꯁꯇꯇꯒꯤ
খৃষ্টনা	ꯈ꯭ꯔꯤꯁꯇꯅ
খৃষ্টমাস	ꯈ꯭ꯔꯤꯁꯇꯃꯥꯁ
খৃষ্টমাসকী	ꯈ꯭ꯔꯤꯁꯇꯃꯥꯁꯀꯤ
খৃষ্টান	ꯈ꯭ꯔꯤꯁꯇꯥꯟ
খেকমন	ꯈꯦꯛꯃꯟ
খেন্নবশিং	ꯈꯦꯟꯅꯕꯁꯤꯡ
খেন্নবা	ꯈꯦꯟꯅꯕ
খেমচান্দনা	ꯈꯦꯝꯆꯥꯟꯗꯅ
খেল	ꯈꯦꯜ
খেলেন	ꯈꯦꯂꯦꯟ
খেৎনবা	ꯈꯦꯠꯅꯕ
খৈনি	ꯈꯩꯅꯤ
খ্বাই	ꯈ꯭ꯋꯥꯢ
খ্বাইগী	ꯈ꯭ꯋꯥꯢꯒꯤ
খ্বাইদগী	ꯈ꯭ꯋꯥꯢꯗꯒꯤ
খ্বাইরম্বন্দ	ꯈ꯭ꯋꯥꯢꯔꯝꯕꯟꯗ
খ্বাইরম্বন্দগী	ꯈ꯭ꯋꯥꯢꯔꯝꯕꯟꯗꯒꯤ
খ্বাইরম্বন্দদা	ꯈ꯭ꯋꯥꯢꯔꯝꯕꯟꯗꯗ
খ্বাইরাকপম	ꯈ꯭ꯋꯥꯢꯔꯥꯛꯄꯝ
খ্রাইষ্ট	ꯈ꯭ꯔꯥꯢꯁꯇ
খ্রে	ꯈ꯭ꯔꯦ
খৎন	ꯈꯠꯅ
খয়াত্তা	ꯈꯌꯥꯠꯇꯥ
গঙ্গা	ꯒꯡꯒꯥ
গঞ্জা	ꯒꯟꯖꯥ
গদকারিনা	ꯒꯗꯀꯥꯔꯤꯅ
গন	ꯒꯟ
গনি	ꯒꯅꯤ
গনেশ	ꯒꯅꯦꯁ
গনেস	ꯒꯅꯦꯁ
গবর্ণমেন্টকী	ꯒꯕꯔꯅꯃꯦꯟꯇꯀꯤ
গবর্ণর	ꯒꯕꯔꯅꯔ
গভর্নমেন্ট	ꯒꯚꯔꯅꯃꯦꯟꯇ
গভর্নর	ꯒꯚꯔꯅꯔ
গভর্নরনা	ꯒꯚꯔꯅꯔꯅ
গম্ভির	ꯒꯝꯚꯤꯔ
গরিব	ꯒꯔꯤꯕ
গর্লস	ꯒꯔꯂꯁ
গলি	ꯒꯂꯤ
গলিদা	ꯒꯂꯤꯗ
গলৱান	ꯒꯜꯋꯥꯟ
গসু	ꯒꯁꯨ
গা	ꯒꯥ
গাংতে	ꯒꯥꯡꯇꯦ
গাংমৈনা	ꯒꯥꯡꯃꯩꯅ
গাইদ	ꯒꯥꯢꯗ
গাইদলাইন	ꯒꯥꯢꯗꯂꯥꯢꯟ
গাইদলাইনগী	ꯒꯥꯢꯗꯂꯥꯢꯟꯒꯤ
গাইদলাইনশিং	ꯒꯥꯢꯗꯂꯥꯢꯟꯁꯤꯡ
গাও	ꯒꯥꯎ
গাজিয়াবাদতা	ꯒꯥꯖꯤꯌꯥꯕꯥꯗꯇ
গাড়ী	ꯒꯥꯗ়ꯤ
গাড়ীশিং	ꯒꯥꯗ়ꯤꯁꯤꯪ
গান	ꯒꯥꯅ
গার্দ	ꯒꯥꯔꯗ
গার্দনা	ꯒꯥꯔꯗꯅ
গার্দেন	ꯒꯥꯔꯗꯦꯟ
গার্ল	ꯒꯥꯔꯜ
গার্লস	ꯒꯥꯔꯜꯁ
গালর্স	ꯒꯥꯂꯔꯁ
গিগা	ꯒꯤꯒꯥ
গিটরিষ্ট	ꯒꯤꯇꯔꯤꯁ꯭ꯇ
গিতা	ꯒꯤꯇꯥ
গিতানা	ꯒꯤꯇꯥꯅ
গিল্ড	ꯒꯤꯜꯗ
গী	ꯒꯤ
গীতা	ꯒꯤꯇꯥ
গীদমক	ꯒꯤꯗꯃꯛ
গীদা	ꯒꯤꯗꯥ
গীনা	ꯒꯤꯅꯥ
গীনি	ꯒꯤꯅꯤ
গীসু	ꯒꯤꯁꯨ
গুগল	ꯒꯨꯒꯜ
গুজরাট	ꯒꯨꯖꯔꯥꯠ
গুজরাটতগী	ꯒꯨꯖꯔꯥꯠꯇꯒꯤ
গুজরাত	ꯒꯨꯖꯔꯥꯇ
গুজরাতকী	ꯒꯨꯖꯔꯥꯠꯀꯤ
গুজরাত্তনা	ꯒꯨꯖꯔꯥꯠꯇꯅ
গুজরাত্তা	ꯒꯨꯖꯔꯥꯠꯇ
গুদ	ꯒꯨꯗ
গুদস	ꯒꯨꯗꯁ
গুন	ꯒꯨꯟ
গুননা	ꯒꯨꯟꯅ
গুনি	ꯒꯨꯅꯤ
গুপ্ত	ꯒꯨꯞꯇ
গুপ্তনা	ꯒꯨꯞꯇꯅ
গুপ্তা	ꯒꯨꯞꯇꯥ
গুরু	ꯒꯨꯔꯨ
গুরুগী	ꯒꯨꯔꯨꯒꯤ
গুরুনা	ꯒꯨꯔꯨꯅꯥ
গুলি	ꯒꯨꯂꯤ
গুলেরিয়ানা	ꯒꯨꯂꯦꯔꯤꯌꯥꯅ
গে	ꯒꯦ
গেং	ꯒꯦꯡ
গেজ	ꯒꯦꯖ
গেজেট	ꯒꯦꯖꯦꯠ
গেজেটতা	ꯒꯦꯖꯦꯠꯇ
গেট	ꯒꯦꯠ
গেটতা	ꯒꯦꯠꯇ
গেটৱে	ꯒꯦꯠꯋꯦ
গেম	ꯒꯦꯝ
গেমস	ꯒꯦꯝꯁ
গেমসকী	ꯒꯦꯝꯁꯀꯤ
গেমসতা	ꯒꯦꯝꯁꯇ
গেষ্ট	ꯒꯦꯁ꯭ꯇ
গেহু	ꯒꯦꯍꯨ
গ্রান্ট	ꯒ꯭ꯔꯥꯟꯇ
গ্রান্দ	ꯒ꯭ꯔꯥꯟꯗ
গ্রান্দেদা	ꯒ꯭ꯔꯥꯟꯗꯦꯗ
গ্রাফর	ꯒ꯭ꯔꯥꯐꯔ
গ্রাম	ꯒ꯭ꯔꯥꯝ
গ্রাস	ꯒ꯭ꯔꯥꯁ
গ্রাসরুট	ꯒ꯭ꯔꯥꯁꯔꯨꯠ
গ্রিন	ꯒ꯭ꯔꯤꯟ
গ্রীন	ꯒ꯭ꯔꯤꯟ
গ্রুপ	ꯒ꯭ꯔꯨꯞ
গ্রুপকী	ꯒ꯭ꯔꯨꯄꯀꯤ
গ্রুপনা	ꯒ꯭ꯔꯨꯄꯅ
গ্রুপশিং	ꯒ꯭ꯔꯨꯄꯁꯤꯡ
গ্রুপশিংগী	ꯒ꯭ꯔꯨꯄꯁꯤꯡꯒꯤ
গ্রুপশিংনা	ꯒ꯭ꯔꯨꯞꯁꯤꯡꯅ
গ্রুপস	ꯒ꯭ꯔꯨꯞꯁ
গ্রুপ্তা	ꯒ꯭ꯔꯨꯞꯇ
গ্রেজুয়েট	ꯒ꯭ꯔꯦꯖꯨꯌꯦꯠ
গ্রেজুয়েসন	ꯒ꯭ꯔꯦꯖꯨꯌꯦꯁꯟ
গ্রেট	ꯒ꯭ꯔꯦꯇ
গ্রেটর	ꯒ꯭ꯔꯦꯇꯔ
গ্রেদ	ꯒ꯭ꯔꯦꯗ
গ্রেনেদ	ꯒ꯭ꯔꯦꯅꯦꯗ
গ্রেসিয়া	ꯒ꯭ꯔꯦꯁꯤꯌꯥ
গ্লাস	ꯒ꯭ꯂꯥꯁ
গৱা	ꯒꯋꯥ
গৱাগী	ꯒꯋꯥꯒꯤ
গৱাদা	ꯒꯋꯥꯗ
ঘর	ꯘꯔ
ঘরি	ꯘꯔꯤ
ঙ	ꯉ
ঙংদুনা	ꯉꯪꯗꯨꯅꯥ
ঙক	ꯉꯛ
ঙক্না	ꯉꯛꯅꯥ
ঙনখৎনা	ꯉꯟꯈꯠꯅ
ঙনমল্লি	ꯉꯟꯃꯜꯂꯤ
ঙন্তা	ꯉꯟꯇꯥ
ঙন্তাদগী	ꯉꯟꯇꯥꯗꯒꯤ
ঙন্না	ꯉꯟꯅ
ঙমখি	ꯉꯝꯈꯤ
ঙমখিদবনি	ꯉꯝꯈꯤꯗꯕꯅꯤ
ঙমখিদবা	ꯉꯝꯈꯤꯗꯕ
ঙমখিদে	ꯉꯝꯈꯤꯗꯦ
ঙমখিদ্রবসু	ꯉꯝꯈꯤꯗ꯭ꯔꯕꯁꯨ
ঙমখিদ্রে	ꯉꯝꯈꯤꯗ꯭ꯔꯦ
ঙমখিবগা	ꯉꯝꯈꯤꯕꯒ
ঙমখিবদা	ꯉꯝꯈꯤꯕꯗ
ঙমখিবনি	ꯉꯝꯈꯤꯕꯅꯤ
ঙমখিবা	ꯉꯝꯈꯤꯕ
ঙমখৈ	ꯉꯝꯈꯩ
ঙমখৈগা	ꯉꯝꯈꯩꯒ
ঙমখৈগী	ꯉꯝꯈꯩꯒꯤ
ঙমখৈদগী	ꯉꯝꯈꯩꯗꯒꯤ
ঙমখৈদা	ꯉꯝꯈꯩꯗ
ঙমখ্রবা	ꯉꯝꯈ꯭ꯔꯕ
ঙমখ্রে	ꯉꯝꯈ꯭ꯔꯦ
ঙমগদগে	ꯉꯝꯒꯗꯒꯦ
ঙমগদবনি	ꯉꯝꯒꯗꯕꯅꯤ
ঙমগদবা	ꯉꯝꯒꯗꯕ
ঙমগদ্রা	ꯉꯝꯒꯗ꯭ꯔꯥ
ঙমগনি	ꯉꯝꯒꯅꯤ
ঙমজদবা	ꯉꯝꯖꯗꯕ
ঙমজনবা	ꯉꯝꯖꯅꯕ
ঙমজবা	ꯉꯝꯖꯕ
ঙমজবি	ꯉꯝꯖꯕꯤ
ঙমজরে	ꯉꯝꯖꯔꯦ
ঙমথং	ꯉꯝꯊꯪ
ঙমদনা	ꯉꯝꯗꯅ
ঙমদবগী	ꯉꯝꯗꯕꯒꯤ
ঙমদবদগী	ꯉꯝꯗꯕꯗꯒꯤ
ঙমদবনা	ꯉꯝꯗꯕꯅ
ঙমদবনি	ꯉꯝꯗꯕꯅꯤ
ঙমদবা	ꯉꯝꯗꯕ
ঙমদুনা	ꯉꯝꯗꯨꯅ
ঙমদে	ꯉꯝꯗꯦ
ঙমদ্রবদি	ꯉꯝꯗ꯭ꯔꯕꯗꯤ
ঙমদ্রবসু	ꯉꯝꯗ꯭ꯔꯕꯁꯨ
ঙমদ্রবা	ꯉꯝꯗ꯭ꯔꯕ
ঙমদ্রি	ꯉꯝꯗ꯭ꯔꯤ
ঙমদ্রিঙৈ	ꯉꯝꯗ꯭ꯔꯤꯉꯩ
ঙমদ্রিবনা	ꯉꯝꯗ꯭ꯔꯤꯕꯅ
ঙমদ্রিবা	ꯉꯝꯗ꯭ꯔꯤꯕ
ঙমদ্রে	ꯉꯝꯗ꯭ꯔꯦ
ঙমলে	ꯉꯝꯂꯦ
ঙমহনগনি	ꯉꯝꯍꯟꯒꯅꯤ
ঙমহনবা	ꯉꯝꯍꯟꯕ
ঙমহন্নবা	ꯉꯝꯍꯟꯅꯕ
ঙমহল্লি	ꯉꯝꯍꯜꯂꯤ
ঙমহল্লে	ꯉꯝꯍꯜꯂꯦ
ঙম্ননবগী	ꯉꯝꯅꯅꯕꯒꯤ
ঙম্ননবা	ꯉꯝꯅꯅꯕ
ঙম্নবগী	ꯉꯝꯅꯕꯒꯤ
ঙম্নবগীদমক	ꯉꯝꯅꯕꯒꯤꯗꯃꯛ
ঙম্নবনি	ꯉꯝꯅꯕꯅꯤ
ঙম্নবা	ꯉꯝꯅꯕ
ঙম্না	ꯉꯝꯅꯥ
ঙম্বগা	ꯉꯝꯕꯒ
ঙম্বগী	ꯉꯝꯕꯒꯤ
ঙম্বগীদমক	ꯉꯝꯕꯒꯤꯗꯃꯛ
ঙম্বগে	ꯉꯝꯕꯒꯦ
ঙম্বতা	ꯉꯝꯕꯇ
ঙম্বদগীনি	ꯉꯝꯕꯗꯒꯤꯅꯤ
ঙম্বদা	ꯉꯝꯕꯗ
ঙম্বদি	ꯉꯝꯕꯗꯤ
ঙম্বদু	ꯉꯝꯕꯗꯨ
ঙম্বনি	ꯉꯝꯕꯅꯤ
ঙম্বশিং	ꯉꯝꯕꯁꯤꯡ
ঙম্বশিংনা	ꯉꯝꯕꯁꯤꯡꯅ
ঙম্বা	ꯉꯝꯕ
ঙম্বী	ꯉꯝꯕꯤ
ঙম্মি	ꯉꯝꯃꯤ
ঙম্মী	ꯉꯝꯃꯤ
ঙম্লকপা	ꯉꯝꯂꯛꯄ
ঙম্লগনি	ꯉꯝꯂꯒꯅꯤ
ঙম্লবদি	ꯉꯝꯂꯕꯗꯤ
ঙম্লবসু	ꯉꯝꯂꯕꯁꯨ
ঙম্লবা	ꯉꯝꯂꯕ
ঙম্লমদবা	ꯉꯝꯂꯝꯗꯕ
ঙম্লমদে	ꯉꯝꯂꯝꯗꯦ
ঙম্লম্মী	ꯉꯝꯂꯝꯃꯤ
ঙম্লি	ꯉꯝꯂꯤ
ঙম্লিবনি	ꯉꯝꯂꯤꯕꯅꯤ
ঙম্লিবমখৈ	ꯉꯝꯂꯤꯕꯝꯈꯩ
ঙম্লিবা	ꯉꯝꯂꯤꯕ
ঙম্লে	ꯉꯝꯂꯦ
ঙরাং	ꯉꯔꯥꯡ
ঙরাংগী	ꯉꯔꯥꯡꯒꯤ
ঙরাংদগী	ꯉꯔꯥꯡꯗꯒꯤ
ঙরাংনা	ꯉꯔꯥꯡꯅ
ঙরাংসু	ꯉꯔꯥꯡꯁꯨ
ঙল্লিঙৈদগী	ꯉꯜꯂꯤꯉꯩꯗꯒꯤ
ঙসাই	ꯉꯁꯥꯏ
ঙসাইগী	ꯉꯁꯥꯏꯒꯤ
ঙসি	ꯉꯁꯤ
ঙসিগা	ꯉꯁꯤꯒ
ঙসিগী	ꯉꯁꯤꯒꯤ
ঙসিদগী	ꯉꯁꯤꯗꯒꯤ
ঙসিদগীদি	ꯉꯁꯤꯗꯒꯤꯗꯤ
ঙসিদি	ꯉꯁꯤꯗꯤ
ঙসিনা	ꯉꯁꯤꯅ
ঙসিমক	ꯉꯁꯤꯃꯛ
ঙসিসু	ꯉꯁꯤꯁꯨ
ঙা	ꯉꯥ
ঙাং	ꯉꯥꯡ
ঙাংই	ꯉꯥꯡꯏ
ঙাংদুনা	ꯉꯥꯡꯗꯨꯅ
ঙাংনবা	ꯉꯥꯡꯅꯕ
ঙাংনা	ꯉꯥꯪꯅꯥ
ঙাংবগী	ꯉꯥꯡꯕꯒꯤ
ঙাংবদা	ꯉꯥꯡꯕꯗꯥ
ঙাংবম	ꯉꯥꯡꯕꯝ
ঙাংবা	ꯉꯥꯡꯕ
ঙাই	ꯉꯥꯢ
ঙাইখিবা	ꯉꯥꯢꯈꯤꯕ
ঙাইখ্রে	ꯉꯥꯏꯈꯔꯦ
ঙাইদুনা	ꯉꯥꯢꯗꯨꯅ
ঙাইনদুনা	ꯉꯥꯢꯅꯗꯨꯅ
ঙাইনবা	ꯉꯥꯢꯅꯕ
ঙাইনরি	ꯉꯥꯢꯅꯔꯤ
ঙাইনা	ꯉꯥꯢꯅ
ঙাইবদা	ꯉꯥꯏꯕꯗꯥ
ঙাইবা	ꯉꯥꯏꯕꯥ
ঙাইরগা	ꯉꯥꯢꯔꯒ
ঙাইরবদা	ꯉꯥꯏꯔꯕꯗꯥ
ঙাইরবা	ꯉꯥꯢꯔꯕ
ঙাইরাংবম	ꯉꯥꯢꯔꯥꯡꯕꯝ
ঙাইরি	ꯉꯥꯢꯔꯤ
ঙাইরিঙৈদা	ꯉꯥꯢꯔꯤꯉꯩꯗ
ঙাইরিবা	ꯉꯥꯢꯔꯤꯕ
ঙাইরিবী	ꯉꯥꯢꯔꯤꯕꯤ
ঙাইরে	ꯉꯥꯢꯔꯦ
ঙাইহাক	ꯉꯥꯢꯍꯥꯛ
ঙাইহাক্কী	ꯉꯥꯢꯍꯥꯛꯀꯤ
ঙাওই	ꯉꯥꯑꯣꯏ
ঙাওবা	ꯉꯥꯎꯕ
ঙাওরবা	ꯉꯥꯑꯣꯔꯕꯥ
ঙাওরে	ꯉꯥꯑꯣꯔꯦ
ঙাক	ꯉꯥꯀ
ঙাকপগা	ꯉꯥꯛꯄꯒ
ঙাকপগী	ꯉꯥꯛꯄꯒꯤ
ঙাকপদা	ꯉꯥꯛꯄꯗ
ঙাকপনচিংবা	ꯉꯥꯛꯄꯅꯆꯤꯡꯕ
ঙাকপা	ꯉꯥꯛꯄ
ঙাকপী	ꯉꯥꯛꯄꯤ
ঙাকপীনবা	ꯉꯥꯛꯄꯤꯅꯕ
ঙাকপীবা	ꯉꯥꯛꯄꯤꯕ
ঙাকহন্নবা	ꯉꯥꯛꯍꯟꯅꯕ
ঙাক্কদবনি	ꯉꯥꯛꯀꯗꯕꯅꯤ
ঙাক্কনি	ꯉꯥꯛꯀꯅꯤ
ঙাক্ননবা	ꯉꯥꯛꯅꯅꯕ
ঙাক্নবসু	ꯉꯥꯛꯅꯕꯁꯨ
ঙাক্নবা	ꯉꯥꯛꯅꯕ
ঙাক্না	ꯉꯥꯛꯅꯥ
ঙাক্লগা	ꯉꯥꯀꯂꯒ
ঙাক্লবতদা	ꯉꯥꯀꯂꯕꯇꯗ
ঙাক্লবদি	ꯉꯥꯀꯂꯕꯗꯤ
ঙাক্লিবা	ꯉꯥꯛꯂꯤꯕ
ঙাখা	ꯉꯥꯈꯥ
ঙাগী	ꯉꯥꯒꯤ
ঙাঙলদুনা	ꯉꯥꯉꯜꯗꯨꯅꯥ
ঙাথু	ꯉꯥꯊꯨ
ঙাথেম	ꯉꯥꯊꯦꯝ
ঙানবগী	ꯉꯥꯅꯕꯒꯤ
ঙানবা	ꯉꯥꯅꯕꯥ
ঙানা	ꯉꯥꯅ
ঙানু	ꯉꯥꯅꯨ
ঙান্থক	ꯉꯥꯟꯊꯛ
ঙাবু	ꯉꯥꯕꯨ
ঙামী	ꯉꯥꯃꯤ
ঙামীশিংগী	ꯉꯥꯃꯤꯁꯤꯡꯒꯤ
ঙামীশিংনা	ꯉꯥꯃꯤꯁꯤꯡꯅ
ঙামু	ꯉꯥꯃꯨ
ঙারী	ꯉꯥꯔꯤ
ঙাল্লিবা	ꯉꯥꯜꯂꯤꯕꯥ
ঙাশিং	ꯉꯥꯁꯤꯡ
ঙাশিংদু	ꯉꯥꯁꯤꯪꯗꯨ
ঙায়বা	ꯉꯥꯢꯕ
ঙায়রবা	ꯉꯥꯢꯔꯕ
ঙায়রিবা	ꯉꯥꯢꯔꯤꯕ
ঙায়রিবী	ꯉꯥꯢꯔꯤꯕꯤ
ঙায়রে	ꯉꯥꯢꯔꯦ
চ	ꯆ
চং	ꯆꯪ
চংই	ꯆꯪꯏ
চংখি	ꯆꯪꯈꯤ
চংখিগনি	ꯆꯪꯈꯤꯒꯅꯤ
চংখিদে	ꯆꯪꯈꯤꯗꯦ
চংখিবনি	ꯆꯪꯈꯤꯕꯅꯤ
চংখিবা	ꯆꯪꯈꯤꯕ
চংখ্রে	ꯆꯪꯈ꯭ꯔꯦ
চংগদবা	ꯆꯪꯒꯗꯕ
চংগনি	ꯆꯪꯒꯅꯤ
চংজখি	ꯆꯪꯖꯈꯤ
চংজখ্রে	ꯆꯪꯖꯈ꯭ꯔꯦ
চংজফম	ꯆꯪꯖꯐꯝ
চংজরকখি	ꯆꯪꯖꯔꯛꯈꯤ
চংদনা	ꯆꯪꯗꯅ
চংদবা	ꯆꯪꯗꯕ
চংদুনা	ꯆꯪꯗꯨꯅ
চংদ্রবা	ꯆꯪꯗ꯭ꯔꯕ
চংদ্রিঙৈ	ꯆꯪꯗ꯭ꯔꯤꯉꯩ
চংদ্রিঙৈদা	ꯆꯪꯗꯔꯤꯉꯩꯗ
চংনবগী	ꯆꯪꯅꯕꯒꯤ
চংনা	ꯆꯪꯅ
চংফম	ꯆꯪꯐꯝ
চংবগা	ꯆꯪꯕꯒ
চংবগী	ꯆꯪꯕꯒꯤ
চংবদগী	ꯆꯪꯕꯗꯒꯤ
চংবদা	ꯆꯪꯕꯗ
চংবদি	ꯆꯪꯕꯗꯤ
চংবা	ꯆꯪꯕ
চংলকখি	ꯆꯪꯂꯛꯈꯤ
চংলকখিবনি	ꯆꯪꯂꯛꯈꯤꯕꯅꯤ
চংলকপগা	ꯆꯪꯂꯛꯄꯒ
চংলকপদা	ꯆꯪꯂꯛꯄꯗ
চংলকপা	ꯆꯪꯂꯛꯄ
চংলক্নবগী	ꯆꯪꯂꯛꯅꯕꯒꯤ
চংলক্লগা	ꯆꯪꯂꯛꯂꯒ
চংলক্লি	ꯆꯪꯂꯛꯂꯤ
চংলক্লিবা	ꯆꯪꯂꯛꯂꯤꯕ
চংলগা	ꯆꯪꯂꯒ
চংলি	ꯆꯪꯂꯤ
চংলিবসি	ꯆꯪꯂꯤꯕꯁꯤ
চংলিবা	ꯆꯪꯂꯤꯕ
চংলে	ꯆꯪꯂꯦ
চংল্লকখিবা	ꯆꯪꯂꯂꯛꯈꯤꯕ
চংশিন	ꯆꯪꯁꯤꯟ
চংশিনখি	ꯆꯪꯁꯤꯟꯈꯤ
চংশিনখিগনি	ꯆꯪꯁꯤꯟꯈꯤꯒꯅꯤ
চংশিনখিবনি	ꯆꯪꯁꯤꯟꯈꯤꯕꯅꯤ
চংশিনখিবা	ꯆꯪꯁꯤꯟꯈꯤꯕ
চংশিনখ্রে	ꯆꯪꯁꯤꯟꯈ꯭ꯔꯦ
চংশিনবগী	ꯆꯪꯁꯤꯟꯕꯒꯤ
চংশিনবদা	ꯆꯪꯁꯤꯟꯕꯗ
চংশিনবা	ꯆꯪꯁꯤꯟꯕ
চংশিন্দুনা	ꯆꯪꯁꯤꯟꯗꯨꯅ
চংশিন্ননবা	ꯆꯪꯁꯤꯟꯅꯅꯕ
চংশিন্নবা	ꯆꯪꯁꯤꯟꯅꯕ
চংশিল্লকখি	ꯆꯪꯁꯤꯜꯂꯛꯈꯤ
চংশিল্লকপগা	ꯆꯪꯁꯤꯜꯂꯛꯄꯒ
চংশিল্লকপগী	ꯆꯪꯁꯤꯜꯂꯛꯄꯒꯤ
চংশিল্লকপনি	ꯆꯪꯁꯤꯜꯂꯛꯄꯅꯤ
চংশিল্লকপা	ꯆꯪꯁꯤꯜꯂꯛꯄ
চংশিল্লক্লি	ꯆꯪꯁꯤꯜꯂꯛꯂꯤ
চংশিল্লক্লিবা	ꯆꯪꯁꯤꯜꯂꯛꯂꯤꯕ
চংশিল্লগা	ꯆꯪꯁꯤꯜꯂꯒ
চংশিল্লম্বা	ꯆꯪꯁꯤꯜꯂꯝꯕ
চংশিল্লসি	ꯆꯪꯁꯤꯜꯂꯁꯤ
চংশিল্লি	ꯆꯪꯁꯤꯜꯂꯤ
চংশিল্লিবশিংনা	ꯆꯪꯁꯤꯜꯂꯤꯕꯁꯤꯡꯅ
চংশিল্লিবা	ꯆꯪꯁꯤꯜꯂꯤꯕ
চংশিল্লে	ꯆꯪꯁꯤꯜꯂꯦ
চংহনবা	ꯆꯪꯍꯟꯕ
চক	ꯆꯛ
চকপি	ꯆꯛꯄꯤ
চক্র	ꯆꯀ꯭ꯔ
চগুংননা	ꯆꯒꯨꯪꯅꯅꯥ
চঙবা	ꯆꯡꯕꯥ
চঙবীয়ু	ꯆꯡꯕꯤꯌꯨ
চঙশিনখ্রে	ꯆꯡꯁꯤꯅꯈꯔꯦ
চঙশিনগনি	ꯆꯡꯁꯤꯅꯒꯅꯤ
চঙশিন্দুনা	ꯆꯡꯁꯤꯟꯗꯨꯅꯥ
চঙশিল্লকখি	ꯆꯡꯁꯤꯜꯂꯛꯈꯤ
চঙশিল্লগনি	ꯆꯡꯁꯤꯜꯂꯒꯅꯤ
চঙশিল্লি	ꯆꯡꯁꯤꯜꯂꯤ
চঙাঙ্গৈ	ꯆꯉꯥꯡꯒꯩ
চজিং	ꯆꯖꯤꯡ
চজিংনা	ꯆꯖꯤꯡꯅ
চত্তবা	ꯆꯠꯇꯕ
চত্তা	ꯆꯠꯇꯥ
চত্তুনা	ꯆꯠꯇꯨꯅ
চত্থখি	ꯆꯠꯊꯈꯤ
চত্থখিগনি	ꯆꯠꯊꯈꯤꯒꯅꯤ
চত্থখিবগীদমক	ꯆꯠꯊꯈꯤꯕꯒꯤꯗꯃꯛ
চত্থখিবনি	ꯆꯠꯊꯈꯤꯕꯅꯤ
চত্থখিবা	ꯆꯠꯊꯈꯤꯕ
চত্থখ্রে	ꯆꯠꯊꯈ꯭ꯔꯦ
চত্থগদবনি	ꯆꯠꯊꯒꯗꯕꯅꯤ
চত্থগদবা	ꯆꯠꯊꯒꯗꯕ
চত্থগনি	ꯆꯠꯊꯒꯅꯤ
চত্থদনবা	ꯆꯠꯊꯗꯅꯕ
চত্থদুনা	ꯆꯠꯊꯗꯨꯅ
চত্থনবগী	ꯆꯠꯊꯅꯕꯒꯤ
চত্থনবা	ꯆꯠꯊꯅꯕ
চত্থনরি	ꯆꯠꯊꯅꯔꯤ
চত্থবগী	ꯆꯠꯊꯕꯒꯤ
চত্থবগীদমক	ꯆꯠꯊꯕꯒꯤꯗꯃꯛ
চত্থবদা	ꯆꯠꯊꯕꯗ
চত্থবদি	ꯆꯠꯊꯕꯗꯤ
চত্থবনা	ꯆꯠꯊꯕꯅ
চত্থবনি	ꯆꯠꯊꯕꯅꯤ
চত্থবা	ꯆꯠꯊꯕ
চত্থরকখি	ꯆꯠꯊꯔꯛꯈꯤ
চত্থরকখিবনি	ꯆꯠꯊꯔꯛꯈꯤꯕꯅꯤ
চত্থরকখিবা	ꯆꯠꯊꯔꯛꯈꯤꯕ
চত্থরকপদগী	ꯆꯠꯊꯔꯛꯄꯗꯒꯤ
চত্থরকপদা	ꯆꯠꯊꯔꯛꯄꯗ
চত্থরকপনি	ꯆꯠꯊꯔꯛꯄꯅꯤ
চত্থরকপা	ꯆꯠꯊꯔꯛꯄ
চত্থরক্লবা	ꯆꯠꯊꯔꯛꯂꯕ
চত্থরক্লি	ꯆꯠꯊꯔꯛꯂꯤ
চত্থরক্লিবা	ꯆꯠꯊꯔꯛꯂꯤꯕ
চত্থরগনি	ꯆꯠꯊꯔꯒꯅꯤ
চত্থরবদি	ꯆꯠꯊꯔꯕꯗꯤ
চত্থরবা	ꯆꯠꯊꯔꯕ
চত্থরম্বা	ꯆꯠꯊꯔꯝꯕ
চত্থরি	ꯆꯠꯊꯔꯤ
চত্থরিঙৈ	ꯆꯠꯊꯔꯤꯉꯩ
চত্থরিবনা	ꯆꯠꯊꯔꯤꯕꯅ
চত্থরিবনি	ꯆꯠꯊꯔꯤꯕꯅꯤ
চত্থরিবা	ꯆꯠꯊꯔꯤꯕ
চত্থরে	ꯆꯠꯊꯔꯦ
চত্থহন্দনবা	ꯆꯠꯊꯍꯟꯗꯅꯕ
চত্থৈ	ꯆꯠꯊꯩ
চন	ꯆꯟ
চনখি	ꯆꯟꯈꯤ
চনখিবনি	ꯆꯟꯈꯤꯕꯅꯤ
চনখিবা	ꯆꯟꯈꯤꯕ
চনখ্রবা	ꯆꯟꯈ꯭ꯔꯕ
চনবগী	ꯆꯅꯕꯒꯤ
চনবদা	ꯆꯅꯕꯗ
চনবসু	ꯆꯅꯕꯁꯨ
চনবা	ꯆꯅꯕ
চনম	ꯆꯅꯝ
চনশিনখ্রে	ꯆꯟꯁꯤꯟꯈ꯭ꯔꯦ
চনা	ꯆꯅꯥ
চনিং	ꯆꯅꯤꯡ
চনী	ꯆꯅꯤ
চনু	ꯆꯅꯨ
চনুগী	ꯆꯅꯨꯒꯤ
চনুনা	ꯆꯅꯨꯅ
চনুরা	ꯆꯅꯨꯔꯥ
চনৈনবা	ꯆꯅꯩꯅꯕ
চন্দন	ꯆꯟꯗꯟ
চন্দে	ꯆꯟꯗꯦ
চন্দ্র	ꯆꯟꯗ꯭ꯔ
চন্দ্রকৃতি	ꯆꯟꯗ꯭ꯔꯀ꯭ꯔꯤꯇꯤ
চন্দ্রনা	ꯆꯟꯗ꯭ꯔꯅ
চন্নদুনা	ꯆꯟꯅꯗꯨꯅ
চন্নবগী	ꯆꯟꯅꯕꯒꯤ
চন্নবা	ꯆꯟꯅꯕ
চন্না	ꯆꯟꯅ
চপ	ꯆꯞ
চপচানা	ꯆꯞꯆꯥꯅꯥ
চপ্লগা	ꯆꯞꯂꯒꯥ
চফু	ꯆꯐꯨ
চফুদা	ꯆꯐꯨꯗ
চবা	ꯆꯕꯥ
চবুন	ꯆꯕꯨꯟ
চমজবা	ꯆꯝꯖꯕ
চমন	ꯆꯃꯟ
চমম্নবা	ꯆꯃꯝꯅꯕ
চম্না	ꯆꯝꯅ
চম্পারন	ꯆꯝꯄꯥꯔꯟ
চম্প্রা	ꯆꯝꯄ꯭ꯔꯥ
চম্বা	ꯆꯝꯕ
চম্লবা	ꯆꯝꯂꯕ
চরন	ꯆꯔꯟ
চরা	ꯆꯔꯥ
চরাংনবা	ꯆꯔꯥꯡꯅꯕ
চরৈ	ꯆꯔꯩ
চর্চ	ꯆꯔꯆ
চর্চকী	ꯆꯔꯆꯀꯤ
চলহন্নবা	ꯆꯜꯍꯟꯅꯕ
চলহল্লু	ꯆꯜꯍꯜꯂꯨ
চলাইবা	ꯆꯂꯥꯢꯕ
চলাইরি	ꯆꯂꯥꯢꯔꯤ
চলান	ꯆꯂꯥꯟ
চল্লকপদা	ꯆꯜꯂꯛꯄꯗ
চল্লকপা	ꯆꯜꯂꯛꯄ
চল্লক্লে	ꯆꯜꯂꯛꯂꯦ
চল্লবনি	ꯆꯜꯂꯕꯅꯤ
চল্লবা	ꯆꯜꯂꯕ
চল্লাইবগী	ꯆꯜꯂꯥꯢꯕꯒꯤ
চল্লাইবদা	ꯆꯜꯂꯥꯢꯕꯗ
চল্লাইবা	ꯆꯜꯂꯥꯢꯕ
চল্লাইরিবা	ꯆꯜꯂꯥꯢꯔꯤꯕ
চল্লি	ꯆꯜꯂꯤ
চল্লিঙৈদা	ꯆꯜꯂꯤꯉꯩꯗꯥ
চল্লে	ꯆꯜꯂꯦ
চহি	ꯆꯍꯤ
চহিগা	ꯆꯍꯤꯒ
চহিগী	ꯆꯍꯤꯒꯤ
চহিদদি	ꯆꯍꯤꯗꯗꯤ
চহিদা	ꯆꯍꯤꯗ
চহিনা	ꯆꯍꯤꯅ
চহিশিংদা	ꯆꯍꯤꯁꯤꯡꯗ
চহিসিগী	ꯆꯍꯤꯁꯤꯒꯤ
চহিসিদা	ꯆꯍꯤꯁꯤꯗ
চহী	ꯆꯍꯤ
চহীগী	ꯆꯍꯤꯒꯤ
চহীদগী	ꯆꯍꯤꯗꯒꯤ
চহীদদি	ꯆꯍꯤꯗꯗꯤ
চহীদা	ꯆꯍꯤꯗ
চহীদি	ꯆꯍꯤꯗꯤ
চহীনা	ꯆꯍꯤꯅ
চহীশিংদদি	ꯆꯍꯤꯁꯤꯡꯗꯗꯤ
চহীশিংদা	ꯆꯍꯤꯁꯤꯡꯗ
চহীসিগী	ꯆꯍꯤꯁꯤꯒꯤ
চহীসু	ꯆꯍꯤꯁꯨ
চহুম	ꯆꯍꯨꯝ
চা	ꯆꯥ
চাং	ꯆꯥꯡ
চাংগী	ꯆꯥꯡꯒꯤ
চাংচৎতা	ꯆꯥꯡꯆꯠꯇ
চাংদগী	ꯆꯥꯡꯗꯒꯤ
চাংদনি	ꯆꯥꯡꯗꯅꯤ
চাংদম	ꯆꯥꯡꯗꯝ
চাংদম্নখি	ꯆꯥꯡꯗꯝꯅꯈꯤ
চাংদম্নখিবা	ꯆꯥꯡꯗꯝꯅꯈꯤꯕ
চাংদম্নবগী	ꯆꯥꯡꯗꯝꯅꯕꯒꯤ
চাংদম্নবদা	ꯆꯥꯡꯗꯝꯅꯕꯗ
চাংদম্নবা	ꯆꯥꯡꯗꯝꯅꯕ
চাংদম্নরুবদা	ꯆꯥꯡꯗꯝꯅꯔꯨꯕꯗ
চাংদসু	ꯆꯥꯡꯗꯁꯨ
চাংদা	ꯆꯥꯡꯗ
চাংদি	ꯆꯥꯡꯗꯤ
চাংনা	ꯆꯥꯡꯅꯥ
চাংনি	ꯆꯥꯡꯅꯤ
চাংশিং	ꯆꯥꯡꯁꯤꯡ
চাংসু	ꯆꯥꯡꯁꯨ
চাংয়েং	ꯆꯥꯡꯌꯦꯡ
চাংয়েংগী	ꯆꯥꯡꯌꯦꯡꯒꯤ
চাংয়েংদা	ꯆꯥꯡꯌꯦꯡꯗ
চাই	ꯆꯥꯢ
চাইনা	ꯆꯥꯢꯅꯥ
চাইনাগা	ꯆꯥꯢꯅꯥꯒ
চাইনাগী	ꯆꯥꯢꯅꯥꯒꯤ
চাইনাদগী	ꯆꯥꯢꯅꯥꯗꯒꯤ
চাইনাদা	ꯆꯥꯢꯅꯥꯗ
চাইনানা	ꯆꯥꯢꯅꯥꯅ
চাইনাবু	ꯆꯥꯢꯅꯥꯕꯨ
চাইনিজ	ꯆꯥꯢꯅꯤꯖ
চাইবী	ꯆꯥꯢꯕꯤ
চাইরম্বা	ꯆꯥꯢꯔꯝꯕ
চাইরে	ꯆꯥꯏꯔꯦ
চাইল্ড	ꯆꯥꯢꯂ꯭ꯗ
চাও	ꯆꯥꯑꯣ
চাওই	ꯆꯥꯎꯏ
চাওখ্রবা	ꯆꯥꯑꯣꯈꯔ꯭ꯕꯥ
চাওখৎ	ꯆꯥꯎꯈꯠ
চাওখৎনবগীদমক	ꯆꯥꯎꯈꯠꯅꯕꯒꯤꯗꯃꯛ
চাওখৎনবা	ꯆꯥꯎꯈꯠꯅꯕ
চাওখৎপগী	ꯆꯥꯎꯈꯠꯄꯒꯤ
চাওখৎপা	ꯆꯥꯎꯈꯠꯄ
চাওখৎলকপগী	ꯆꯥꯎꯈꯠꯂꯛꯄꯒꯤ
চাওখৎলকপা	ꯆꯥꯎꯈꯠꯂꯛꯄ
চাওখৎলক্লি	ꯆꯥꯎꯈꯠꯂꯛꯂꯤ
চাওখৎলক্লিবা	ꯆꯥꯎꯈꯠꯂꯛꯂꯤꯕ
চাওখৎলবসু	ꯆꯥꯎꯈꯠꯂꯕꯁꯨ
চাওখৎলবা	ꯆꯥꯎꯈꯠꯂꯕ
চাওখৎলে	ꯆꯥꯎꯈꯠꯂꯦ
চাওখৎহনবা	ꯆꯥꯎꯈꯠꯍꯟꯕ
চাওখৎহন্নবগী	ꯆꯥꯎꯈꯠꯍꯟꯅꯕꯒꯤ
চাওখৎহন্নবা	ꯆꯥꯎꯈꯠꯍꯟꯅꯕ
চাওনা	ꯆꯥꯎꯅ
চাওবগী	ꯆꯥꯎꯕꯒꯤ
চাওবা	ꯆꯥꯎꯕ
চাওরবা	ꯆꯥꯎꯔꯕ
চাওরাক্না	ꯆꯥꯎꯔꯥꯛꯅ
চাওশিনবা	ꯆꯥꯎꯁꯤꯟꯕ
চাওশিন্না	ꯆꯥꯎꯁꯤꯟꯅ
চাক	ꯆꯥꯛ
চাকখিবনি	ꯆꯥꯛꯈꯤꯕꯅꯤ
চাকখিবা	ꯆꯥꯛꯈꯤꯕ
চাকখুম	ꯆꯥꯛꯈꯨꯝ
চাকখ্রবা	ꯆꯥꯛꯈ꯭ꯔꯕ
চাকখ্রে	ꯆꯥꯀꯈ꯭ꯔꯦ
চাকচা	ꯆꯥꯛꯆꯥ
চাকথুং	ꯆꯥꯛꯊꯨꯡ
চাকথেকপী	ꯆꯥꯛꯊꯦꯛꯄꯤ
চাকপগী	ꯆꯥꯛꯄꯒꯤ
চাকপদগী	ꯆꯥꯛꯄꯗꯒꯤ
চাকপদা	ꯆꯥꯛꯄꯗ
চাকপা	ꯆꯥꯛꯄ
চাকহেন	ꯆꯥꯛꯍꯦꯟ
চাকা	ꯆꯥꯀꯥ
চাক্কী	ꯆꯥꯛꯀꯤ
চাক্না	ꯆꯥꯛꯅꯥ
চাক্লাম	ꯆꯥꯛꯂꯥꯝ
চাক্লে	ꯆꯥꯛꯂꯦ
চাক্লেন	ꯆꯥꯛꯂꯦꯟ
চাখিবদু	ꯆꯥꯈꯤꯕꯗꯨ
চাখিবা	ꯆꯥꯈꯤꯕꯥ
চাগদবনি	ꯆꯥꯒꯗꯕꯅꯤ
চাগদবা	ꯆꯥꯒꯗꯕ
চাগনি	ꯆꯥꯒꯅꯤ
চাগী	ꯆꯥꯒꯤ
চাগে	ꯆꯥꯒꯦ
চাদ	ꯆꯥꯗ
চাদনা	ꯆꯥꯗꯅ
চাদবা	ꯆꯥꯗꯕ
চাদা	ꯆꯥꯗ
চাদিং	ꯆꯥꯗꯤꯡ
চাদুনা	ꯆꯥꯗꯨꯅ
চাদে	ꯆꯥꯗꯦ
চান	ꯆꯥꯅ
চানদনা	ꯆꯥꯅꯗꯅꯥ
চাননবা	ꯆꯥꯅꯅꯕ
চাননা	ꯆꯥꯅꯅꯥ
চানবগীদমক	ꯆꯥꯅꯕꯒꯤꯗꯃꯛ
চানবা	ꯆꯥꯅꯕ
চানরিবা	ꯆꯥꯅꯔꯤꯕ
চানা	ꯆꯅꯥ
চানি	ꯆꯥꯅꯤ
চানিংঙাই	ꯆꯥꯅꯤꯪꯉꯥꯏ
চান্দ	ꯆꯥꯟꯗ
চান্দনা	ꯆꯥꯟꯗꯅ
চান্দিগর	ꯆꯥꯟꯗꯤꯒꯔ
চান্দিগরগী	ꯆꯥꯟꯗꯤꯒꯔꯒꯤ
চান্দিগরদা	ꯆꯥꯟꯗꯤꯒꯔꯗ
চান্দেল	ꯆꯥꯟꯗꯦꯜ
চান্দেলগী	ꯆꯥꯟꯗꯦꯜꯒꯤ
চান্দেলদগী	ꯆꯥꯟꯗꯦꯜꯗꯒꯤ
চান্দেলদা	ꯆꯥꯟꯗꯦꯜꯗ
চান্দেলনা	ꯆꯥꯟꯗꯦꯜꯅ
চান্ন	ꯆꯥꯟꯅ
চান্নগদবা	ꯆꯥꯟꯅꯒꯗꯕ
চান্ননা	ꯆꯥꯟꯅꯅ
চান্নবা	ꯆꯥꯟꯅꯕ
চান্নরিব্রা	ꯆꯥꯟꯅꯔꯤꯕ꯭ꯔ
চান্না	ꯆꯥꯟꯅꯥ
চান্সেলর	ꯆꯥꯟꯁꯦꯂꯔ
চাফম	ꯆꯥꯐꯝ
চাবগী	ꯆꯥꯕꯒꯤ
চাবদা	ꯆꯥꯕꯗ
চাবনা	ꯆꯥꯕꯅ
চাবসু	ꯆꯥꯕꯁꯨ
চাবা	ꯆꯥꯕ
চামগী	ꯆꯥꯃꯒꯤ
চামা	ꯆꯥꯃ
চামিন	ꯆꯥꯃꯤꯟ
চামিন্নখি	ꯆꯥꯃꯤꯟꯅꯈꯤ
চাম্মা	ꯆꯥꯝꯃ
চারগা	ꯆꯥꯔꯒꯥ
চারবদি	ꯆꯥꯔꯕꯗꯤ
চারবা	ꯆꯥꯔꯕ
চারম্বা	ꯆꯥꯔꯝꯕꯥ
চারা	ꯆꯥꯔꯥ
চারিঙৈদা	ꯆꯥꯔꯤꯉꯩꯗꯥ
চারিবা	ꯆꯥꯔꯤꯕ
চারে	ꯆꯥꯔꯦ
চার্জ	ꯆꯥꯔꯖ
চার্জসু	ꯆꯥꯔꯖꯁꯨ
চার্টর	ꯆꯥꯔꯇꯔ
চার্লস	ꯆꯥꯔꯜꯁ
চাহন্নবা	ꯆꯥꯍꯟꯅꯅꯕ
চায়	ꯆꯥꯌ
চিং	ꯆꯤꯡ
চিংই	ꯆꯤꯪꯏ
চিংখৈ	ꯆꯤꯡꯈꯩ
চিংখৎকনি	ꯆꯤꯡꯈꯠꯀꯅꯤ
চিংখৎনবা	ꯆꯤꯡꯈꯠꯅꯕ
চিংগী	ꯆꯤꯡꯒꯤ
চিংঙা	ꯆꯤꯡꯉꯥ
চিংথদুনা	ꯆꯤꯡꯊꯗꯨꯅ
চিংথনবা	ꯆꯤꯡꯊꯅꯕ
চিংথাম	ꯆꯤꯡꯊꯥꯝ
চিংদুনা	ꯆꯤꯪꯗꯨꯅꯥ
চিংননিংঙাই	ꯆꯤꯡꯅꯅꯤꯡꯉꯥꯢ
চিংনবগী	ꯆꯤꯡꯅꯕꯒꯤ
চিংনবদগী	ꯆꯤꯡꯅꯕꯗꯒꯤ
চিংনবনা	ꯆꯤꯪꯅꯕꯅꯥ
চিংনবা	ꯆꯤꯡꯅꯕ
চিংনরবদি	ꯆꯤꯡꯅꯔꯕꯗꯤ
চিংনরি	ꯆꯤꯡꯅꯔꯤ
চিংনা	ꯆꯤꯡꯅ
চিংবা	ꯆꯤꯡꯕ
চিংলগা	ꯆꯤꯪꯂꯒꯥ
চিংলেনসনা	ꯆꯤꯡꯂꯦꯟꯁꯅꯥ
চিংশাং	ꯆꯤꯡꯁꯥꯡ
চিংশিনখি	ꯆꯤꯡꯁꯤꯟꯈꯤ
চিংশিনখ্রে	ꯆꯤꯡꯁꯤꯟꯈ꯭ꯔꯦ
চিংশিনবগা	ꯆꯤꯡꯁꯤꯟꯕꯒ
চিংশিনবা	ꯆꯤꯡꯁꯤꯟꯕ
চিংশিন্নবা	ꯆꯤꯡꯁꯤꯟꯅꯕ
চিংশিন্নিংঙাই	ꯆꯤꯡꯁꯤꯟꯅꯤꯡꯉꯥꯢ
চিংশিল্লক্লি	ꯆꯤꯡꯁꯤꯜꯂꯛꯂꯤ
চিংশিল্লদুনা	ꯆꯤꯡꯁꯤꯜꯂꯗꯨꯅ
চিংশিল্লি	ꯆꯤꯡꯁꯤꯜꯂꯤ
চিকপা	ꯆꯤꯛꯄ
চিক্না	ꯆꯤꯛꯅꯥ
চিঙাই	ꯆꯤꯉꯥꯢ
চিঙাখম	ꯆꯤꯉꯥꯈꯝ
চিঠি	ꯆꯤꯊꯤ
চিত্থদনা	ꯆꯤꯠꯊꯗꯅ
চিদাইদা	ꯆꯤꯗꯥꯢꯗ
চিন	ꯆꯤꯟ
চিনদগী	ꯆꯤꯟꯗꯒꯤ
চিনদা	ꯆꯤꯟꯗ
চিনবগী	ꯆꯤꯟꯕꯒꯤ
চিনবা	ꯆꯤꯟꯕ
চিনা	ꯆꯤꯅꯥ
চিনাগী	ꯆꯤꯅꯥꯒꯤ
চিনাদা	ꯆꯤꯅꯥꯗ
চিনি	ꯆꯤꯅꯤ
চিন্ননা	ꯆꯤꯟꯅꯅ
চিফ	ꯆꯤꯐ
চিফাংনা	ꯆꯤꯐꯥꯡꯅ
চিরাং	ꯆꯤꯔꯥꯡ
চিরাগ	ꯆꯤꯔꯥꯒ
চিরুগী	ꯆꯤꯔꯨꯒꯤ
চিলদ্রেন	ꯆꯤꯜꯗ꯭ꯔꯦꯟ
চিল্লি	ꯆꯤꯜꯂꯤ
চিয়ার	ꯆꯤꯌꯥꯔ
চীং	ꯆꯤꯡ
চীংখৈ	ꯆꯤꯡꯈꯩ
চীংগী	ꯆꯤꯡꯒꯤ
চীংঙা	ꯆꯤꯡꯉꯥ
চীংদগী	ꯆꯤꯡꯗꯒꯤ
চীংদা	ꯆꯤꯡꯗ
চীংনবা	ꯆꯤꯡꯅꯕ
চীংনা	ꯆꯤꯡꯅ
চীংনুং	ꯆꯤꯪꯅꯨꯪ
চীংমাংদা	ꯆꯤꯡꯃꯥꯡꯗ
চীংমায়	ꯆꯤꯪꯃꯥꯌ
চীংমী	ꯆꯤꯡꯃꯤ
চীংলেম্না	ꯆꯤꯪꯂꯦꯝꯅꯥ
চীংশাং	ꯆꯤꯡꯁꯥꯡ
চীংশাংগী	ꯆꯤꯡꯁꯥꯡꯒꯤ
চীংশিনখি	ꯆꯤꯡꯁꯤꯟꯈꯤ
চীংয়া	ꯆꯤꯡꯌꯥ
চীকপদগী	ꯆꯤꯛꯄꯗꯒꯤ
চীক্না	ꯆꯤꯛꯅ
চীঞ্জাক	ꯆꯤꯟꯖꯥꯛ
চীঞ্জাকশিংগী	ꯆꯤꯟꯖꯥꯛꯁꯤꯡꯒꯤ
চীন্দা	ꯆꯤꯟꯗꯥ
চীফ	ꯆꯤꯐ
চু	ꯆꯨ
চুং	ꯆꯨꯡ
চুংখাম	ꯆꯨꯡꯈꯥꯝ
চুংশিন্নদুনা	ꯆꯨꯡꯁꯤꯟꯅꯗꯨꯅ
চুংশিন্নবা	ꯆꯨꯡꯁꯤꯟꯅꯕ
চুংশিন্নরি	ꯆꯨꯡꯁꯤꯟꯅꯔꯤ
চুই	ꯆꯨꯢ
চুখি	ꯆꯨꯈꯤ
চুখিবা	ꯆꯨꯈꯤꯕ
চুগী	ꯆꯨꯒꯤ
চুদুনা	ꯆꯨꯗꯨꯅ
চুনবা	ꯆꯨꯅꯕ
চুনরবা	ꯆꯨꯅꯔꯕ
চুন্নবা	ꯆꯨꯟꯅꯕ
চুপ্না	ꯆꯨꯞꯅꯥ
চুপ্পগী	ꯆꯨꯞꯄꯒꯤ
চুপ্পদা	ꯆꯨꯞꯄꯗ
চুপ্পা	ꯆꯨꯞꯄ
চুপ্লি	ꯆꯨꯞꯂꯤ
চুফম	ꯆꯨꯐꯝ
চুবগা	ꯆꯨꯕꯒ
চুবগী	ꯆꯨꯕꯒꯤ
চুবদগী	ꯆꯨꯕꯗꯒꯤ
চুবনা	ꯆꯨꯕꯅ
চুবা	ꯆꯨꯕ
চুমগনি	ꯆꯨꯝꯒꯅꯤ
চুমথাং	ꯆꯨꯝꯊꯥꯡ
চুমদবা	ꯆꯨꯝꯗꯕ
চুমদে	ꯆꯨꯝꯗꯦ
চুম্নগী	ꯆꯨꯝꯅꯒꯤ
চুম্না	ꯆꯨꯝꯅ
চুম্বা	ꯆꯨꯝꯕ
চুম্মী	ꯆꯨꯝꯃꯤ
চুম্লবদি	ꯆꯨꯝꯂꯕꯗꯤ
চুম্লবা	ꯆꯨꯝꯂꯕꯥ
চুরচান্দপুর	ꯆꯨꯔꯆꯥꯟꯗꯄꯨꯔ
চুরবা	ꯆꯨꯔꯕꯥ
চুরাচান্দপুর	ꯆꯨꯔꯥꯆꯥꯟꯗꯄꯨꯔ
চুরাচান্দপুরগী	ꯆꯨꯔꯥꯆꯥꯟꯗꯄꯨꯔꯒꯤ
চুরাচান্দপুরদগী	ꯆꯨꯔꯥꯆꯥꯟꯗꯄꯨꯔꯗꯒꯤ
চুরাচান্দপুরদসু	ꯆꯨꯔꯥꯆꯥꯟꯗꯄꯨꯔꯗꯁꯨ
চুরাচান্দপুরদা	ꯆꯨꯔꯥꯆꯥꯟꯗꯄꯨꯔꯗ
চুরান্দপুর	ꯆꯨꯔꯥꯟꯗꯄꯨꯔ
চুরি	ꯆꯨꯔꯤ
চুরুট	ꯆꯨꯔꯨꯠ
চুরুপ	ꯆꯨꯔꯨꯞ
চুশিন্ননা	ꯆꯨꯁꯤꯟꯅꯅ
চুশিন্নবা	ꯆꯨꯁꯤꯟꯅꯕ
চুশিন্নৈ	ꯆꯨꯁꯤꯟꯅꯩ
চূপ্না	ꯆꯨꯞꯅꯥ
চূপ্পা	ꯆꯨꯞꯄꯥ
চূপ্লি	ꯆꯨꯞꯂꯤ
চূম্না	ꯆꯨꯝꯅꯥ
চে	ꯆꯦ
চেং	ꯆꯦꯡ
চেংগী	ꯆꯦꯡꯒꯤ
চেংগুম	ꯆꯦꯡꯒꯨꯝ
চেংলৈ	ꯆꯦꯡꯂꯩ
চেক	ꯆꯦꯛ
চেকঅপ	ꯆꯦꯛꯑꯞ
চেকশিন	ꯆꯦꯛꯁꯤꯟ
চেকশিনগদবা	ꯆꯦꯛꯁꯤꯟꯒꯗꯕ
চেকশিনদবা	ꯆꯦꯛꯁꯤꯟꯗꯕ
চেকশিনবগা	ꯆꯦꯛꯁꯤꯟꯕꯒ
চেকশিনবগী	ꯆꯦꯛꯁꯤꯟꯕꯒꯤ
চেকশিনবা	ꯆꯦꯛꯁꯤꯟꯕ
চেকশিন্নবা	ꯆꯦꯛꯁꯤꯟꯅꯕ
চেকশিন্না	ꯆꯦꯛꯁꯤꯟꯅ
চেকশিল্লবা	ꯆꯦꯛꯁꯤꯜꯂꯕ
চেক্লা	ꯆꯦꯛꯂꯥ
চেগী	ꯆꯦꯒꯤ
চেঙ	ꯆꯦꯉ
চেঞ্জ	ꯆꯦꯟꯖ
চেঞ্জগা	ꯆꯦꯟꯖꯒ
চেঞ্জগী	ꯆꯦꯟꯖꯒꯤ
চেঞ্জতা	ꯆꯦꯟꯖꯇ
চেঞ্জনা	ꯆꯦꯟꯖꯅ
চেন	ꯆꯦꯟ
চেনখি	ꯆꯦꯟꯈꯤ
চেনখিবা	ꯆꯦꯟꯈꯤꯕ
চেনগনি	ꯆꯦꯟꯒꯅꯤ
চেনবগা	ꯆꯦꯟꯕꯒ
চেনবগী	ꯆꯦꯟꯕꯒꯤ
চেনবদা	ꯆꯦꯟꯕꯗ
চেনবা	ꯆꯦꯟꯕ
চেনবী	ꯆꯦꯟꯕꯤ
চেনশিন	ꯆꯦꯟꯁꯤꯟ
চেনশিল্লকপা	ꯆꯦꯟꯁꯤꯜꯂꯛꯄ
চেনা	ꯆꯦꯅꯥ
চেনেল	ꯆꯦꯅꯦꯜ
চেনেলদা	ꯆꯦꯅꯦꯜꯗ
চেনেলশিং	ꯆꯦꯅꯦꯜꯁꯤꯡ
চেনেলশিংদা	ꯆꯦꯅꯦꯜꯁꯤꯡꯗ
চেন্থরকপা	ꯆꯦꯟꯊꯔꯛꯄ
চেন্দবা	ꯆꯦꯟꯗꯕꯥ
চেন্দুনা	ꯆꯦꯟꯗꯨꯅꯥ
চেন্নদ্রে	ꯆꯦꯟꯅꯗ꯭ꯔꯦ
চেন্নবনি	ꯆꯦꯟꯅꯕꯅꯤ
চেন্নবশিং	ꯆꯦꯟꯅꯕꯁꯤꯡ
চেন্নবা	ꯆꯦꯟꯅꯕ
চেন্নরিবশিং	ꯆꯦꯟꯅꯔꯤꯕꯁꯤꯡ
চেন্নরিবা	ꯆꯦꯟꯅꯔꯤꯕ
চেন্নরে	ꯆꯦꯟꯅꯔꯦ
চেন্না	ꯆꯦꯟꯅꯥ
চেন্নাই	ꯆꯦꯟꯅꯥꯢ
চেন্নাইগী	ꯆꯦꯟꯅꯥꯢꯒꯤ
চেন্নাইদা	ꯆꯦꯟꯅꯥꯢꯗ
চেন্নেল	ꯆꯦꯟꯅꯦꯜ
চেন্নেলদা	ꯆꯦꯟꯅꯦꯜꯗ
চেন্নেলশিং	ꯆꯦꯟꯅꯦꯜꯁꯤꯡ
চেন্নৈ	ꯆꯦꯟꯅꯩ
চেম্পিয়ন	ꯆꯦꯝꯄꯤꯌꯟ
চেম্পিয়নসিপ	ꯆꯦꯝꯄꯤꯌꯟꯁꯤꯞ
চেম্বর	ꯆꯦꯝꯕꯔ
চেম্বরদা	ꯆꯦꯝꯕꯔꯗ
চেরেল	ꯆꯦꯔꯦꯜ
চেলহল্লি	ꯆꯦꯜꯍꯜꯂꯤ
চেলেঞ্জ	ꯆꯦꯂꯦꯟꯖ
চেল্লকপা	ꯆꯦꯜꯂꯛꯄ
চেল্লগা	ꯆꯦꯜꯂꯒꯥ
চেল্লম্বা	ꯆꯦꯜꯂꯝꯕ
চেল্লি	ꯆꯦꯜꯂꯤ
চেল্লিবসি	ꯆꯦꯜꯂꯤꯕꯁꯤ
চেল্লিবা	ꯆꯦꯜꯂꯤꯕ
চেল্লে	ꯆꯦꯜꯂꯦ
চেল্লেঞ্জ	ꯆꯦꯜꯂꯦꯟꯖ
চেশিংদা	ꯆꯦꯁꯤꯡꯗ
চেৎনা	ꯆꯦꯠꯅ
চেৎপা	ꯆꯦꯠꯄ
চৈ	ꯆꯩ
চৈখি	ꯆꯩꯈꯤ
চৈগী	ꯆꯩꯒꯤ
চৈথেং	ꯆꯩꯊꯦꯡ
চৈথেংগী	ꯆꯩꯊꯦꯡꯒꯤ
চৈথেংদগী	ꯆꯩꯊꯦꯡꯗꯒꯤ
চৈথেংনা	ꯆꯩꯊꯦꯡꯅ
চৈদুনা	ꯆꯩꯗꯨꯅꯥ
চৈনবগী	ꯆꯩꯅꯕꯒꯤ
চৈনবনা	ꯆꯩꯅꯕꯅ
চৈনা	ꯆꯩꯅꯥ
চৈবনা	ꯆꯩꯕꯅꯥ
চৈবা	ꯆꯩꯕ
চৈরক	ꯆꯩꯔꯛ
চৈরাও	ꯆꯩꯔꯥꯎ
চৈরাওবা	ꯆꯩꯔꯥꯎꯕ
চৈরাক	ꯆꯩꯔꯥꯛ
চৈশিং	ꯆꯩꯁꯤꯡ
চ্যেক	ꯆꯦꯛ
চ্যেন	ꯆꯦꯟ
চৎ	ꯆꯠ
চৎকদগে	ꯆꯠꯀꯗꯒꯦ
চৎকদবনি	ꯆꯠꯀꯗꯕꯅꯤ
চৎকদবা	ꯆꯠꯀꯗꯕ
চৎকনি	ꯆꯠꯀꯅꯤ
চৎখি	ꯆꯠꯈꯤ
চৎখিগদবা	ꯆꯠꯈꯤꯒꯗꯕ
চৎখিদুনা	ꯆꯠꯈꯤꯗꯨꯅ
চৎখিদে	ꯆꯠꯈꯤꯗꯦ
চৎখিবদি	ꯆꯠꯈꯤꯕꯗꯤ
চৎখিবনি	ꯆꯠꯈꯤꯕꯅꯤ
চৎখিবা	ꯆꯠꯈꯤꯕ
চৎখ্রবা	ꯆꯠꯈ꯭ꯔꯕ
চৎখ্রে	ꯆꯠꯈ꯭ꯔꯦ
চৎচবা	ꯆꯠꯆꯕ
চৎতনবা	ꯆꯠꯇꯅꯕ
চৎতবা	ꯆꯠꯇꯕ
চৎতুনা	ꯆꯠꯇꯨꯅ
চৎথরক্লিবা	ꯆꯠꯊꯔꯛꯂꯤꯕ
চৎথরিবা	ꯆꯠꯊꯔꯤꯕ
চৎন	ꯆꯠꯅ
চৎনখি	ꯆꯠꯅꯈꯤ
চৎনখিবা	ꯆꯠꯅꯈꯤꯕ
চৎনগদবা	ꯆꯠꯅꯒꯗꯕ
চৎনগনি	ꯆꯠꯅꯒꯅꯤ
চৎনদুনা	ꯆꯠꯅꯗꯨꯅ
চৎনদ্রে	ꯆꯠꯅꯗ꯭ꯔꯦ
চৎননবগী	ꯆꯠꯅꯅꯕꯒꯤ
চৎননবা	ꯆꯠꯅꯅꯕ
চৎনবগী	ꯆꯠꯅꯕꯒꯤ
চৎনবগীদমক	ꯆꯠꯅꯕꯒꯤꯗꯃꯛ
চৎনবসু	ꯆꯠꯅꯕꯁꯨ
চৎনবা	ꯆꯠꯅꯕ
চৎনবী	ꯆꯠꯅꯕꯤ
চৎনবীগা	ꯆꯠꯅꯕꯤꯒ
চৎনবীগী	ꯆꯠꯅꯕꯤꯒꯤ
চৎনবীনা	ꯆꯠꯅꯕꯤꯅ
চৎনবীনি	ꯆꯠꯅꯕꯤꯅꯤ
চৎনরক্লবা	ꯆꯠꯅꯔꯛꯂꯕ
চৎনরগনি	ꯆꯠꯅꯔꯒꯅꯤ
চৎনরম্বা	ꯆꯠꯅꯔꯝꯕ
চৎনরি	ꯆꯠꯅꯔꯤ
চৎনরিঙৈ	ꯆꯠꯅꯔꯤꯉꯩ
চৎনরিবা	ꯆꯠꯅꯔꯤꯕ
চৎনরে	ꯆꯠꯅꯔꯦ
চৎনহনখিবা	ꯆꯠꯅꯍꯟꯈꯤꯕ
চৎনহনগদবনি	ꯆꯠꯅꯍꯟꯒꯗꯕꯅꯤ
চৎনহনগনি	ꯆꯠꯅꯍꯟꯒꯅꯤ
চৎনহনবগী	ꯆꯠꯅꯍꯟꯕꯒꯤ
চৎনহনবা	ꯆꯠꯅꯍꯟꯕ
চৎনহন্দনবা	ꯆꯠꯅꯍꯟꯗꯅꯕ
চৎনহন্দনা	ꯆꯠꯅꯍꯟꯗꯅ
চৎনহন্ননবা	ꯆꯠꯅꯍꯟꯅꯅꯕ
চৎনহন্নবগী	ꯆꯠꯅꯍꯟꯅꯕꯒꯤ
চৎনহন্নবসু	ꯆꯠꯅꯍꯟꯅꯕꯁꯨ
চৎনহন্নবা	ꯆꯠꯅꯍꯟꯅꯕ
চৎনহল্লি	ꯆꯠꯅꯍꯜꯂꯤ
চৎনহল্লু	ꯆꯠꯅꯍꯜꯂꯨ
চৎনা	ꯆꯠꯅ
চৎপগা	ꯆꯠꯄꯒ
চৎপগী	ꯆꯠꯄꯒꯤ
চৎপদগী	ꯆꯠꯄꯗꯒꯤ
চৎপদা	ꯆꯠꯄꯗ
চৎপনা	ꯆꯠꯄꯅ
চৎপনি	ꯆꯠꯄꯅꯤ
চৎপবু	ꯆꯠꯄꯕꯨ
চৎপসু	ꯆꯠꯄꯁꯨ
চৎপা	ꯆꯠꯄ
চৎপাগী	ꯆꯠꯄꯒꯤ
চৎপীবা	ꯆꯠꯄꯤꯕ
চৎপীয়ু	ꯆꯠꯄꯤꯌꯨ
চৎমিন্নদুনা	ꯆꯠꯃꯤꯟꯅꯗꯨꯅ
চৎমিন্ননবা	ꯆꯠꯃꯤꯟꯅꯅꯕ
চৎমিন্নবগী	ꯆꯠꯃꯤꯟꯅꯕꯒꯤ
চৎমিন্নবা	ꯆꯠꯃꯤꯟꯅꯕ
চৎমিন্নরি	ꯆꯠꯃꯤꯟꯅꯔꯤ
চৎমিন্নরিবা	ꯆꯠꯃꯤꯟꯅꯔꯤꯕ
চৎমীন্নবা	ꯆꯠꯃꯤꯟꯅꯕ
চৎলগনি	ꯆꯠꯂꯒꯅꯤ
চৎলগা	ꯆꯠꯂꯒ
চৎলবদি	ꯆꯠꯂꯕꯗꯤ
চৎলবা	ꯆꯠꯂꯕ
চৎলম্বা	ꯆꯠꯂꯝꯕ
চৎলম্মী	ꯆꯠꯂꯝꯃꯤ
চৎলসি	ꯆꯠꯂꯁꯤ
চৎলি	ꯆꯠꯂꯤ
চৎলিঙৈদা	ꯆꯠꯂꯤꯉꯩꯗ
চৎলিবা	ꯆꯠꯂꯤꯕ
চৎলিব্রা	ꯆꯠꯂꯤꯕ꯭ꯔ
চৎলুদবা	ꯆꯠꯂꯨꯗꯕ
চৎলুবগী	ꯆꯠꯂꯨꯕꯒꯤ
চৎলুবনি	ꯆꯠꯂꯨꯕꯅꯤ
চৎলুবা	ꯆꯠꯂꯨꯕ
চৎলুরগা	ꯆꯠꯂꯨꯔꯒ
চৎলুরবা	ꯆꯠꯂꯨꯔꯕ
চৎলে	ꯆꯠꯂꯦ
চৎশি	ꯆꯠꯁꯤ
চৎশিন	ꯆꯠꯁꯤꯟ
চৎশিনগী	ꯆꯠꯁꯤꯟꯒꯤ
চৎশিনদা	ꯆꯠꯁꯤꯟꯗ
চৎশিন্দা	ꯆꯠꯁꯤꯟꯗ
চৎহনগদবনি	ꯆꯠꯍꯟꯒꯗꯕꯅꯤ
চৎহনবগী	ꯆꯠꯍꯟꯕꯒꯤ
চৎহনবা	ꯆꯠꯍꯟꯕ
চৎহন্দুনা	ꯆꯠꯍꯟꯗꯨꯅ
চৎহন্নবা	ꯆꯠꯍꯟꯅꯕ
চৎহল্লে	ꯆꯠꯍꯜꯂꯦ
চয়েৎনবা	ꯆꯌꯦꯠꯅꯕ
চয়েৎনরিবা	ꯆꯌꯦꯠꯅꯔꯤꯕ
ছতিসগর	ꯁꯇꯤꯁꯒꯔ
ছুতি	ꯁꯨꯇꯤ
ছুতিগী	ꯁꯨꯇꯤꯒꯤ
জগদিস	ꯖꯒꯗꯤꯁ
জগৎ	ꯖꯒꯠ
জঙ্কসন	ꯖꯪꯀꯁꯟ
জঙ্গল	ꯖꯪꯒꯜ
জঙ্গলদা	ꯖꯪꯒꯜꯗ
জজ	ꯖꯖ
জজমেন্ট	ꯖꯖꯃꯦꯟꯇ
জন	ꯖꯟ
জনতা	ꯖꯟꯇꯥ
জননেতা	ꯖꯅꯅꯦꯇꯥ
জনা	ꯖꯅꯥ
জনুৱারি	ꯖꯅꯨꯋꯥꯔꯤ
জন্ম	ꯖꯟꯃ
জন্মভুমিদা	ꯖꯟꯃꯚꯨꯃꯤꯗ
জপান	ꯖꯄꯥꯟ
জপানগা	ꯖꯄꯥꯟꯒ
জপানগী	ꯖꯄꯥꯟꯒꯤ
জপানদা	ꯖꯄꯥꯟꯗ
জপাননা	ꯖꯄꯥꯟꯅ
জপানিজ	ꯖꯄꯥꯅꯤꯖ
জপানিস	ꯖꯄꯥꯅꯤꯁ
জমুনা	ꯖꯃꯨꯅꯥ
জম্মু	ꯖꯝꯃꯨ
জম্মুদা	ꯖꯝꯃꯨꯗ
জর	ꯖꯔ
জর্জ	ꯖꯔꯖ
জর্নেল	ꯖꯔꯅꯦꯜ
জর্নেলিজম	ꯖꯔꯅꯦꯂꯤꯖꯝ
জর্নেলিজমগী	ꯖꯔꯅꯦꯂꯤꯖꯝꯒꯤ
জর্নেলিষ্ট	ꯖꯔꯅꯦꯂꯤꯁꯠ
জর্নেলিষ্টশিং	ꯖꯔꯅꯦꯂꯤꯁꯠꯁꯤꯡ
জর্নেলিষ্টশিংগী	ꯖꯔꯅꯦꯂꯤꯁꯠꯁꯤꯡꯒꯤ
জর্নেলিষ্টশিংদা	ꯖꯔꯅꯦꯂꯤꯁꯠꯁꯤꯡꯗ
জর্নেলিষ্টশিংনা	ꯖꯔꯅꯦꯂꯤꯁꯠꯁꯤꯡꯅ
জর্মনগী	ꯖꯔꯃꯟꯒꯤ
জর্মনি	ꯖꯔꯃꯅꯤ
জর্মনিগী	ꯖꯔꯃꯅꯤꯒꯤ
জর্সি	ꯖꯔꯁꯤ
জল	ꯖꯜ
জলগী	ꯖꯜꯒꯤ
জষ্টিস	ꯖꯁꯇꯤꯁ
জষ্টিসকী	ꯖꯁꯇꯤꯁꯀꯤ
জষ্টিসশিং	ꯖꯁꯇꯤꯁꯁꯤꯡ
জহাজ	ꯖꯍꯥꯖ
জহাজশিং	ꯖꯍꯥꯖꯁꯤꯡ
জাতি	ꯖꯥꯇꯤ
জাতিগী	ꯖꯥꯇꯤꯒꯤ
জাতিগীদমক	ꯖꯥꯇꯤꯒꯤꯗꯃꯛ
জাতিনা	ꯖꯥꯇꯤꯅ
জাতিশিংগী	ꯖꯥꯇꯤꯁꯤꯡꯒꯤ
জাতিসু	ꯖꯥꯇꯤꯁꯨ
জানুৱারী	ꯖꯅꯨꯋꯥꯔꯤ
জানুৱারীদগী	ꯖꯅꯨꯋꯥꯔꯤꯗꯒꯤ
জানুৱারীদা	ꯖꯅꯨꯋꯥꯔꯤꯗ
জাম	ꯖꯥꯝ
জাৎ	ꯖꯥꯠ
জাৎকী	ꯖꯥꯠꯀꯤ
জায়েদনা	ꯖꯥꯌꯦꯗꯅꯥ
জি	ꯖꯤ
জিও	ꯖꯤꯑꯣ
জিওগ্রাফিকেল	ꯖꯤꯑꯣꯒꯔꯥꯐꯤꯀꯦꯜ
জিওফ্রি	ꯖꯤꯑꯣꯐ꯭ꯔꯤ
জিগী	ꯖꯤꯒꯤ
জিতেন	ꯖꯤꯇꯦꯟ
জিতেননা	ꯖꯤꯇꯦꯟꯅ
জিতেন্দ্র	ꯖꯤꯇꯦꯟꯗ꯭ꯔ
জিন	ꯖꯤꯟ
জিনজর	ꯖꯤꯟꯖꯔ
জিনা	ꯖꯤꯅꯥ
জিপ	ꯖꯤꯞ
জিব	ꯖꯤꯕ
জিবন	ꯖꯤꯕꯟ
জিবা	ꯖꯤꯕꯥ
জিম	ꯖꯤꯝ
জিমনাষ্টিক	ꯖꯤꯝꯅꯥꯁ꯭ꯇꯤꯛ
জিরি	ꯖꯤꯔꯤ
জিরিগী	ꯖꯤꯔꯤꯒꯤ
জিরিবাম	ꯖꯤꯔꯤꯕꯥꯝ
জিরিবামগা	ꯖꯤꯔꯤꯕꯥꯝꯒ
জিরিবামগী	ꯖꯤꯔꯤꯕꯥꯝꯒꯤ
জিরিবামদগী	ꯖꯤꯔꯤꯕꯥꯝꯗꯒꯤ
জিরিবামদা	ꯖꯤꯔꯤꯕꯥꯝꯗ
জিলা	ꯖꯤꯂꯥ
জিলানা	ꯖꯤꯂꯥꯅ
জিৎকী	ꯖꯤꯠꯀꯤ
জিৎনা	ꯖꯤꯠꯅ
জিয়া	ꯖꯤꯌꯥ
জীব	ꯖꯤꯕ
জীবনি	ꯖꯤꯕꯅꯤ
জীবশিং	ꯖꯤꯕꯁꯤꯪ
জীবা	ꯖꯤꯕꯥ
জু	ꯖꯨ
জুইস	ꯖꯨꯢꯁ
জুদা	ꯖꯨꯗꯥ
জুদিসিয়ারি	ꯖꯨꯗꯤꯁꯤꯌꯥꯔꯤ
জুদিসিয়ারিনা	ꯖꯨꯗꯤꯁꯤꯌꯥꯔꯤꯅ
জুদিসিয়েল	ꯖꯨꯗꯤꯁꯤꯌꯦꯜ
জুন	ꯖꯨꯟ
জুনগী	ꯖꯨꯟꯒꯤ
জুনদা	ꯖꯨꯟꯗ
জুনিয়র	ꯖꯨꯅꯤꯌ꯭ꯔ
জুনিয়ার	ꯖꯨꯅꯤꯌꯔ
জুবেনাইল	ꯖꯨꯕꯦꯅꯥꯏꯜ
জুব্লি	ꯖꯨꯕ꯭ꯂꯤ
জুম	ꯖꯨꯃ
জুরা	ꯖꯨꯔꯥ
জুরি	ꯖꯨꯔꯤ
জুলাই	ꯖꯨꯂꯥꯢ
জুলাইগী	ꯖꯨꯂꯥꯢꯒꯤ
জুলাইদা	ꯖꯨꯂꯥꯢꯗ
জুৱার	ꯖꯨꯋꯥꯔ
জে	ꯖꯦ
জেএসিনা	ꯖꯦꯑꯦꯁꯤꯅꯥ
জেক	ꯖꯦꯛ
জেট	ꯖꯦꯠ
জেটশিংগী	ꯖꯦꯇꯁꯤꯪꯒꯤ
জেদ	ꯖꯦꯗ
জেনরেল	ꯖꯦꯟꯔꯦꯜ
জেনরেলগী	ꯖꯦꯟꯔꯦꯜꯒꯤ
জেনরেলনা	ꯖꯦꯟꯔꯦꯜꯅ
জেনরেসন	ꯖꯦꯟꯔꯦꯁꯟ
জেনহাং	ꯖꯦꯟꯍꯥꯡ
জেনিমস	ꯖꯦꯅꯤꯝꯁ
জেনিমসকী	ꯖꯦꯅꯤꯝꯁꯀꯤ
জেনিমসতনা	ꯖꯦꯅꯤꯝꯁꯇꯅ
জেনিমসতা	ꯖꯦꯅꯤꯝꯁꯇ
জেনেরেল	ꯖꯦꯅꯦꯔꯦꯜ
জেনেরেলগী	ꯖꯦꯅꯦꯔꯦꯜꯒꯤ
জেনেরেসন	ꯖꯦꯅꯦꯔꯦꯁꯟ
জেন্টলমেন	ꯖꯦꯟꯇꯜꯃꯦꯟ
জেন্দর	ꯖꯦꯟꯗꯔ
জেমস	ꯖꯦꯝꯁ
জেমি	ꯖꯦꯃꯤ
জেরেমি	ꯖꯦꯔꯦꯃꯤ
জেল	ꯖꯦꯜ
জেলগী	ꯖꯦꯜꯒꯤ
জেলদগী	ꯖꯦꯂꯗꯒꯤ
জেলদা	ꯖꯦꯜꯗ
জেলিয়াংনা	ꯖꯦꯂꯤꯌꯥꯡꯅ
জেসামি	ꯖꯦꯁꯥꯃꯤ
জেৎ	ꯖꯦꯠ
জ্ঞান	ꯖꯅꯥꯅ
জ্বার	ꯖ꯭ꯋꯥꯔ
জয়	ꯖꯌ
জয়কিষন	ꯖꯌꯀꯤꯁꯟ
জয়কুমার	ꯖꯌꯀꯨꯃꯥꯔ
জয়কুমারনা	ꯖꯌꯀꯨꯃꯥꯔꯅ
জয়চন্দ্র	ꯖꯌꯆꯟꯗ꯭ꯔ
জয়চন্দ্রনা	ꯖꯌꯆꯟꯗ꯭ꯔꯅ
জয়না	ꯖꯌꯅ
জয়ন্তকুমার	ꯖꯌꯟꯇꯀꯨꯃꯥꯔ
জয়ন্তকুমারনা	ꯖꯌꯟꯇꯀꯨꯃꯥꯔꯅ
জয়পুর	ꯖꯌꯄꯨꯔ
জয়পুরদা	ꯖꯌꯄꯨꯔꯗ
জয়শঙ্করগসু	ꯖꯌꯁꯡꯀꯔꯒꯁꯨ
জয়শঙ্করগা	ꯖꯌꯁꯡꯀꯔꯒ
জয়শঙ্করসু	ꯖꯌꯁꯡꯀꯔꯁꯨ
জয়েন্ত	ꯖꯌꯦꯟꯇ
জয়েন্তকুমার	ꯖꯌꯦꯟꯇꯀꯨꯃꯥꯔ
জয়েন্তনা	ꯖꯌꯦꯟꯇꯅ
জয়েন্তা	ꯖꯌꯦꯟꯇ
জৱান	ꯖꯋꯥꯟ
জৱানশিংনা	ꯖꯋꯥꯟꯁꯤꯡꯅ
জৱাহরলাল	ꯖꯋꯥꯍꯔꯂꯥꯜ
ঝরখন্দ	ꯓꯔꯈꯟꯗ
ঝাং	ꯓꯥꯪ
টন	ꯇꯟ
টর্কি	ꯇꯔꯀꯤ
টর্ফ	ꯇꯔꯐ
টাইটল	ꯇꯥꯢꯇꯜ
টাইতল	ꯇꯥꯢꯇꯜ
টাইপ	ꯇꯥꯏꯞ
টাইব	ꯇꯥꯢꯕ
টাইম	ꯇꯥꯏꯝ
টাইমস	ꯇꯥꯏꯝꯁ
টাক্স	ꯇꯥꯀ꯭ꯁ
টাটা	ꯇꯥꯇꯥ
টার্গেট	ꯇꯥꯔꯒꯦꯠ
টার্ম	ꯇꯥꯔꯝ
টার্মগী	ꯇꯥꯔꯝꯒꯤ
টি	ꯇꯤ
টিঐচ	ꯇꯤꯑꯩꯆ
টিক	ꯇꯤꯛ
টিকেন	ꯇꯤꯀꯦꯟ
টিকেন্দ্র	ꯇꯤꯀꯦꯟꯗ꯭ꯔ
টিকেন্দ্রগী	ꯇꯤꯀꯦꯟꯗ꯭ꯔꯒꯤ
টিকেন্দ্রজিৎ	ꯇꯤꯀꯦꯟꯗ꯭ꯔꯖꯤꯠ
টিকেন্দ্রনা	ꯇꯤꯀꯦꯟꯗ꯭ꯔꯅ
টিকেৎ	ꯇꯤꯀꯦꯠ
টিকেৎতা	ꯇꯤꯀꯦꯠꯇ
টিগী	ꯇꯤꯒꯤ
টিচর	ꯇꯤꯆꯔ
টিচরস	ꯇꯤꯆꯔꯁ
টিচর্স	ꯇꯤꯆꯔꯁ
টিচিং	ꯇꯤꯆꯤꯡ
টিদিম	ꯇꯤꯗꯤꯝ
টিনা	ꯇꯤꯅꯥ
টিনেজর	ꯇꯤꯅꯦꯖꯔ
টিম	ꯇꯤꯝ
টিমগা	ꯇꯤꯝꯒ
টিমগী	ꯇꯤꯝꯒꯤ
টিমদা	ꯇꯤꯝꯗ
টিমনা	ꯇꯤꯝꯅ
টিমবু	ꯇꯤꯝꯕꯨ
টিমশিং	ꯇꯤꯝꯁꯤꯡ
টিমশিংনা	ꯇꯤꯝꯁꯤꯡꯅ
টিমসু	ꯇꯤꯝꯁꯨ
টিশিং	ꯇꯤꯁꯤꯡ
টিহার	ꯇꯤꯍꯥꯔ
টিয়ার	ꯇꯤꯌꯥꯔ
টু	ꯇꯨ
টুটেল	ꯇꯨꯇꯦꯜ
টুদা	ꯇꯨꯗ
টুর	ꯇꯨꯔ
টুরিজম	ꯇꯨꯔꯤꯖꯝ
টুরিজমগী	ꯇꯨꯔꯤꯖꯝꯒꯤ
টুরিষ্ট	ꯇꯨꯔꯤꯁ꯭ꯇ
টুরিষ্টশিং	ꯇꯨꯔꯤꯁ꯭ꯇꯁꯤꯡ
টুরিষ্টশিংনা	ꯇꯨꯔꯤꯁ꯭ꯇꯁꯤꯡꯅ
টুর্নামেন্ট	ꯇꯨꯔꯅꯥꯃꯦꯟꯇ
টুর্নামেন্টকী	ꯇꯨꯔꯅꯥꯃꯦꯟꯇꯀꯤ
টুয়েল্ব	ꯇꯨꯌꯦꯜꯕ
টুয়েল্বকী	ꯇꯨꯌꯦꯜꯕꯀꯤ
টেক	ꯇꯦꯛ
টেকন	ꯇꯦꯀꯟ
টেক্কর	ꯇꯦꯛꯀꯔ
টেক্নিক	ꯇꯦꯛꯅꯤꯛ
টেক্নিকশিং	ꯇꯦꯛꯅꯤꯛꯁꯤꯡ
টেক্নিকেল	ꯇꯦꯛꯅꯤꯀꯦꯜ
টেক্নিকেলগী	ꯇꯦꯛꯅꯤꯀꯦꯜꯒꯤ
টেক্নিসিয়ান	ꯇꯦꯛꯅꯤꯁꯤꯌꯥꯟ
টেক্স	ꯇꯦꯛꯁ
টেক্সকী	ꯇꯦꯛꯁꯀꯤ
টেক্সটাইল	ꯇꯦꯛꯁꯇꯥꯏꯜ
টেক্সি	ꯇꯦꯛꯁꯤ
টেগ	ꯇꯦꯒ
টেঙ্ক	ꯇꯦꯡꯀ
টেঙ্কর	ꯇꯦꯡꯀꯔ
টেঙ্করশিং	ꯇꯦꯡꯀꯔꯁꯤꯡ
টেঙ্কশিং	ꯇꯦꯡꯀꯁꯤꯡ
টেন	ꯇꯦꯟ
টেনগী	ꯇꯦꯟꯒꯤ
টেন্দর	ꯇꯦꯟꯗꯔ
টেপ	ꯇꯦꯞ
টেবল	ꯇꯦꯕꯜ
টেবলদা	ꯇꯦꯕꯜꯗ
টেব্লেট	ꯇꯦꯕꯂꯦꯠ
টেব্লেৎ	ꯇꯦꯕꯂꯦꯠ
টেম্পররি	ꯇꯦꯝꯄꯔꯔꯤ
টেম্পরেচর	ꯇꯦꯝꯄꯔꯦꯆꯔ
টেম্পরেরি	ꯇꯦꯝꯄꯔꯦꯔꯤ
টেম্পল	ꯇꯦꯝꯄꯜ
টেম্পলগী	ꯇꯦꯝꯄꯜꯒꯤ
টেম্পলদা	ꯇꯦꯝꯄꯜꯗ
টেরর	ꯇꯦꯔꯔ
টেলি	ꯇꯦꯂꯤ
টেলিকাষ্ট	ꯇꯦꯂꯤꯀꯥꯁꯠ
টেলিভিজন	ꯇꯦꯂꯤꯚꯤꯖꯟ
টেলিভিজনদা	ꯇꯦꯂꯤꯚꯤꯖꯟꯗ
টেলিভিজননা	ꯇꯦꯂꯤꯚꯤꯖꯟꯅ
টেলেন্ট	ꯇꯦꯂꯦꯟꯇ
টেল্লি	ꯇꯦꯜꯂꯤ
টেল্লিদা	ꯇꯦꯜꯂꯤꯗ
টেষ্ট	ꯇꯦꯁꯠ
টেষ্টকী	ꯇꯦꯁꯠꯀꯤ
টেষ্টতা	ꯇꯦꯁꯠꯇ
টেষ্টতি	ꯇꯦꯁꯠꯇꯤ
টেষ্টশিং	ꯇꯦꯁꯠꯁꯤꯡ
টেষ্টসু	ꯇꯦꯁꯠꯁꯨ
টেষ্টিং	ꯇꯦꯁꯇꯤꯡ
ট্যুন	ꯇ꯭ꯌꯨꯟ
ট্যুব	ꯇ꯭ꯌꯨꯕ
ট্যুসন	ꯇ꯭ꯌꯨꯁꯟ
ট্রক	ꯇ꯭ꯔꯛ
ট্রকশিং	ꯇ꯭ꯔꯛꯁꯤꯡ
ট্রষ্ট	ꯇ꯭ꯔꯁꯠ
ট্রষ্টকী	ꯇ꯭ꯔꯁꯠꯀꯤ
ট্রষ্টনা	ꯇꯔ꯭ꯁꯠꯅ
ট্রি	ꯇ꯭ꯔꯤ
ট্রিট	ꯇ꯭ꯔꯤꯠ
ট্রিটমেন্ট	ꯇ꯭ꯔꯤꯠꯃꯦꯟꯇ
ট্রেক	ꯇ꯭ꯔꯦꯛ
ট্রেনিং	ꯠꯔꯦꯅꯤꯪ
টয়ার	ꯇꯌꯥꯔ
ঠাকুর	ꯊꯥꯀꯨꯔ
ঠিয়েটর	ꯊꯤꯌꯦꯇꯔ
ঠিয়েটরগী	ꯊꯤꯌꯦꯇꯔꯒꯤ
ঠিয়েটরবু	ꯊꯤꯌꯦꯇꯔꯕꯨ
ঠিয়েটরশিং	ꯊꯤꯌꯦꯇꯔꯁꯤꯡ
ড	ꯗ
ডবলসতা	ꯗꯕꯜꯁꯇꯥ
ডব্লিয়ু	ꯗꯕ꯭ꯂꯤꯌꯨ
ডা	ꯗꯥ
ডিপুটি	ꯗꯤꯄꯨꯇꯤ
ডিবিজন	ꯗꯤꯕꯤꯖꯟ
ডে	ꯗꯦ
ডেগা	ꯗꯦꯒ
ডেগী	ꯗꯦꯒꯤ
ডেনা	ꯗꯦꯅ
ড্রগ	ꯗ꯭ꯔꯒ
ড্রগকী	ꯗ꯭ꯔꯒꯀꯤ
ড্রগস	ꯗ꯭ꯔꯒꯁ
ড্রামা	ꯗꯔꯥꯃꯥ
ড্রামাগী	ꯗꯔꯥꯃꯥꯒꯤ
তং	ꯇꯪ
তংখায়	ꯇꯪꯈꯥꯌ
তংদু	ꯇꯪꯗꯨ
তকশিনখি	ꯇꯛꯁꯤꯟꯈꯤ
তকশিনখ্রে	ꯇꯛꯁꯤꯟꯈ꯭ꯔꯦ
তকশিনগনি	ꯇꯛꯁꯤꯟꯒꯅꯤ
তকশিনবগা	ꯇꯛꯁꯤꯟꯕꯒ
তকশিনবা	ꯇꯛꯁꯤꯟꯕ
তকশিন্দুনা	ꯇꯛꯁꯤꯟꯗꯨꯅ
তকশিল্লক্লি	ꯇꯛꯁꯤꯜꯂꯛꯂꯤ
তকশিল্লগনি	ꯇꯛꯁꯤꯜꯂꯒꯅꯤ
তকশিল্লবা	ꯇꯛꯁꯤꯜꯂꯕ
তকশিল্লি	ꯇꯛꯁꯤꯜꯂꯤ
তক্নদুনা	ꯇꯛꯅꯗꯨꯅ
তখেল	ꯇꯈꯦꯜ
তখেল্লম্বম	ꯇꯈꯦꯜꯂꯝꯕꯝ
তগী	ꯇꯒꯤ
তগীনা	ꯇꯒꯤꯅ
তগীনি	ꯇꯒꯤꯅꯤ
তগৎ	ꯇꯒꯠ
তঙাইফদনা	ꯇꯉꯥꯢꯐꯗꯅ
তঙাইফদবগী	ꯇꯉꯥꯢꯐꯗꯕꯒꯤ
তঙাইফদবনি	ꯇꯉꯥꯢꯐꯗꯕꯅꯤ
তঙাইফদবশিং	ꯇꯉꯥꯢꯐꯗꯕꯁꯤꯡ
তঙাইফদবসু	ꯇꯉꯥꯢꯐꯗꯕꯁꯨ
তঙাইফদবা	ꯇꯉꯥꯢꯐꯗꯕ
তঙাইফদে	ꯇꯉꯥꯢꯐꯗꯦ
তঙাইফদ্রবদি	ꯇꯉꯥꯢꯐꯗ꯭ꯔꯕꯗꯤ
তঙাইফদ্রবা	ꯇꯉꯥꯢꯐꯗ꯭ꯔꯕ
তঙাইফদ্রে	ꯇꯉꯥꯢꯐꯗ꯭ꯔꯦ
তঙায়	ꯇꯉꯥꯢ
তঙ্খায়	ꯇꯡꯈꯥꯢ
তত্তনা	ꯇꯠꯇꯅꯥ
তত্তুনা	ꯇꯠꯇꯨꯅ
তথি	ꯇꯊꯤ
তদি	ꯇꯗꯤ
তনা	ꯇꯅꯥ
তনানবা	ꯇꯅꯥꯟꯕ
তনান্না	ꯇꯅꯥꯟꯅ
তনি	ꯇꯅꯤ
তপ	ꯇꯞ
তপ্ন	ꯇꯞꯅ
তপ্না	ꯇꯞꯅ
তপ্পা	ꯇꯞꯄ
তবা	ꯇꯕꯥ
তম	ꯇꯝ
তমক	ꯇꯃꯛ
তমখি	ꯇꯝꯈꯤ
তমখিবনি	ꯇꯝꯈꯤꯕꯅꯤ
তমখ্রে	ꯇꯝꯈ꯭ꯔꯦ
তমগদবা	ꯇꯝꯒꯗꯕ
তমগনি	ꯇꯝꯒꯅꯤ
তমগী	ꯇꯝꯒꯤ
তমজনিংঙাইনি	ꯇꯝꯖꯅꯤꯡꯉꯥꯢꯅꯤ
তমজবা	ꯇꯝꯖꯕ
তমথিনা	ꯇꯝꯊꯤꯅ
তমথিবা	ꯇꯝꯊꯤꯕ
তমথিরবা	ꯇꯝꯊꯤꯔꯕ
তমদা	ꯇꯝꯗ
তমদুনা	ꯇꯝꯗꯨꯅ
তমদ্রিঙৈ	ꯇꯝꯗ꯭ꯔꯤꯉꯩ
তমনা	ꯇꯝꯅ
তমহনবগী	ꯇꯝꯍꯟꯕꯒꯤ
তমহনবা	ꯇꯝꯍꯟꯕ
তমহন্নবগী	ꯇꯝꯍꯟꯅꯕꯒꯤ
তমু	ꯇꯃꯨ
তম্নবগী	ꯇꯝꯅꯕꯒꯤ
তম্নবা	ꯇꯝꯅꯕ
তম্নরি	ꯇꯝꯅꯔꯤ
তম্না	ꯇꯝꯅ
তম্নীংবা	ꯇꯝꯅꯤꯡꯕ
তম্পাক	ꯇꯝꯄꯥꯛ
তম্পাক্কা	ꯇꯝꯄꯥꯛꯀ
তম্পাক্কী	ꯇꯝꯄꯥꯛꯀꯤ
তম্ফম	ꯇꯝꯐꯝ
তম্ফমশঙশিং	ꯇꯝꯐꯝꯁꯪꯁꯤꯡ
তম্ফমশিং	ꯇꯝꯐꯝꯁꯤꯡ
তম্ফমশিংদি	ꯇꯝꯐꯝꯁꯤꯡꯗꯤ
তম্ফা	ꯇꯝꯐꯥ
তম্ফাসনা	ꯇꯝꯐꯥꯁꯅꯥ
তম্বগী	ꯇꯝꯕꯒꯤ
তম্বদগী	ꯇꯝꯕꯗꯒꯤ
তম্বদা	ꯇꯝꯕꯗ
তম্ববু	ꯇꯝꯕꯕꯨ
তম্বা	ꯇꯝꯕ
তম্বিবা	ꯇꯝꯕꯤꯕꯥ
তম্বিয়ু	ꯇꯝꯕꯤꯌꯨ
তম্বী	ꯇꯝꯕꯤ
তম্বীখি	ꯇꯝꯕꯤꯈꯤ
তম্বীগদবনি	ꯇꯝꯕꯤꯒꯗꯕꯅꯤ
তম্বীদুনা	ꯇꯝꯕꯤꯗꯨꯅꯥ
তম্বীনবা	ꯇꯝꯕꯤꯅꯕ
তম্বীবগী	ꯇꯝꯕꯤꯕꯒꯤ
তম্বীবনি	ꯇꯝꯕꯤꯕꯅꯤ
তম্বীবা	ꯇꯝꯕꯤꯕ
তম্বীরম্বশিং	ꯇꯝꯕꯤꯔꯝꯕꯁꯤꯡ
তম্বীরম্বা	ꯇꯝꯕꯤꯔꯝꯕ
তম্বীরি	ꯇꯝꯕꯤꯔꯤ
তম্বীরিবা	ꯇꯝꯕꯤꯔꯤꯕ
তম্বীরে	ꯇꯝꯕꯤꯔꯦ
তম্মগা	ꯇꯝꯃꯒꯥ
তম্মী	ꯇꯝꯃꯤ
তম্মীগী	ꯇꯝꯃꯤꯒꯤ
তম্লকপগী	ꯇꯝꯂꯛꯄꯒꯤ
তম্লকপা	ꯇꯝꯂꯛꯄ
তম্লগনি	ꯇꯝꯂꯒꯅꯤ
তম্লবা	ꯇꯝꯂꯕ
তম্লম্বা	ꯇꯝꯂꯝꯕ
তম্লম্লবদি	ꯇꯝꯂꯝꯂꯕꯗꯤ
তম্লি	ꯇꯝꯂꯤ
তম্লিবা	ꯇꯝꯂꯤꯕ
তম্লিবী	ꯇꯝꯂꯤꯕꯤ
তম্লুবদগী	ꯇꯝꯂꯨꯕꯗꯒꯤ
তম্লুবা	ꯇꯝꯂꯨꯕꯥ
তম্লুরগা	ꯇꯝꯂꯨꯔꯒ
তম্লুরবা	ꯇꯝꯂꯨꯔꯕꯥ
তম্লে	ꯇꯝꯂꯦ
তরা	ꯇꯔꯥ
তরাইনা	ꯇꯔꯥꯢꯅ
তরাগী	ꯇꯔꯥꯒꯤ
তরাদগী	ꯇꯔꯥꯗꯒꯤ
তরাদা	ꯇꯔꯥꯗ
তরানা	ꯇꯔꯥꯅ
তরানি	ꯇꯔꯥꯅꯤ
তরানিগী	ꯇꯔꯥꯅꯤꯒꯤ
তরানিপাল	ꯇꯔꯥꯅꯤꯄꯥꯂ
তরাম	ꯇꯔꯥꯃ
তরামঙা	ꯇꯔꯥꯃꯉꯥ
তরামঙাগী	ꯇꯔꯥꯃꯉꯥꯒꯤ
তরামরি	ꯇꯔꯥꯃꯔꯤ
তরাম্ন	ꯇꯔꯥꯝꯅ
তরাম্না	ꯇꯔꯥꯝꯅ
তরু	ꯇꯔꯨ
তরুক	ꯇꯔꯨꯛ
তরুকনি	ꯇꯔꯨꯛꯅꯤ
তরুকমক	ꯇꯔꯨꯛꯃꯛ
তরুকশুবা	ꯇꯔꯨꯛꯁꯨꯕ
তরুকসু	ꯇꯔꯨꯛꯁꯨ
তরুক্কী	ꯇꯔꯨꯛꯀꯤ
তরুক্না	ꯇꯔꯨꯛꯅ
তরুক্নি	ꯇꯔꯨꯛꯅꯤ
তরুক্লক	ꯇꯔꯨꯛꯂꯛ
তরুনি	ꯇꯔꯨꯅꯤ
তরূক	ꯇꯔꯨꯀ
তরূক্না	ꯇꯔꯨꯛꯅꯥ
তরূক্নি	ꯇꯔꯨꯛꯅꯤ
তরেত	ꯇꯔꯦꯇ
তরেত্তগী	ꯇꯔꯦꯠꯇꯒꯤ
তরেত্তা	ꯇꯔꯦꯠꯇꯥ
তরেৎ	ꯇꯔꯦꯠ
তরেৎকী	ꯇꯔꯦꯠꯀꯤ
তরেৎতগী	ꯇꯔꯦꯠꯇꯒꯤ
তরেৎতা	ꯇꯔꯦꯠꯇ
তরেৎনা	ꯇꯔꯦꯠꯅ
তরেৎনি	ꯇꯔꯦꯠꯅꯤ
তরেৎমক	ꯇꯔꯦꯠꯃꯛ
তরেৎলক	ꯇꯔꯦꯠꯂꯛ
তরেৎশুবা	ꯇꯔꯦꯠꯁꯨꯕ
তরেৎসু	ꯇꯔꯦꯠꯁꯨ
তর্পন	ꯇꯔꯄꯟ
তল	ꯇꯜ
তলব	ꯇꯜꯕ
তলবতগী	ꯇꯜꯕꯇꯒꯤ
তশেং	ꯇꯁꯦꯡ
তশেংনমক	ꯇꯁꯦꯡꯅꯃꯛ
তশেংনা	ꯇꯁꯦꯡꯅ
তশেংবা	ꯇꯁꯦꯡꯕ
তস	ꯇꯁ
তসু	ꯇꯁꯨ
তা	ꯇꯥ
তাং	ꯇꯥꯡ
তাংখুল	ꯇꯥꯡꯈꯨꯜ
তাংদনা	ꯇꯥꯡꯗꯅ
তাংদবা	ꯇꯥꯡꯗꯕ
তাংদুনা	ꯇꯥꯡꯗꯨꯅ
তাংনা	ꯇꯥꯡꯅ
তাংবগী	ꯇꯥꯡꯕꯒꯤ
তাংবা	ꯇꯥꯡꯕ
তাংলবা	ꯇꯥꯡꯂꯕ
তাই	ꯇꯥꯢ
তাইননা	ꯇꯥꯢꯅꯅ
তাইনবদা	ꯇꯥꯏꯟꯕꯗꯥ
তাইনবা	ꯇꯥꯢꯅꯕ
তাইনরিবা	ꯇꯥꯢꯅꯔꯤꯕ
তাইবং	ꯇꯥꯏꯕꯪ
তাইবংদা	ꯇꯥꯢꯕꯪꯗ
তাইবঙ	ꯇꯥꯏꯕꯡ
তাওইনা	ꯇꯥꯎꯏꯅ
তাওবম	ꯇꯥꯎꯕꯝ
তাওবা	ꯇꯥꯎꯕ
তাকখি	ꯇꯥꯛꯈꯤ
তাকপগী	ꯇꯥꯛꯄꯒꯤ
তাকপদা	ꯇꯥꯛꯄꯗ
তাকপদি	ꯇꯥꯛꯄꯗꯤ
তাকপনি	ꯇꯥꯛꯄꯅꯤ
তাকপা	ꯇꯥꯛꯄ
তাকপী	ꯇꯥꯛꯄꯤ
তাকপীবা	ꯇꯥꯛꯄꯤꯕ
তাকপীরম্বশিং	ꯇꯥꯛꯄꯤꯔꯝꯕꯁꯤꯡ
তাকপীরম্বা	ꯇꯥꯛꯄꯤꯔꯝꯕ
তাকপীরম্মী	ꯇꯥꯛꯄꯤꯔꯝꯃꯤ
তাকপীরি	ꯇꯥꯛꯄꯤꯔꯤ
তাকহনখি	ꯇꯥꯛꯍꯟꯈꯤ
তাকহনবগী	ꯇꯥꯛꯍꯟꯕꯒꯤ
তাকহনবা	ꯇꯥꯛꯍꯟꯕ
তাকহল্লিবা	ꯇꯥꯛꯍꯜꯂꯤꯕ
তাক্কনি	ꯇꯥꯛꯀꯅꯤ
তাক্নবা	ꯇꯥꯛꯅꯕ
তাক্লবনি	ꯇꯥꯛꯂꯕꯅꯤ
তাক্লবা	ꯇꯥꯀꯂ꯭ꯕꯥ
তাক্লম্বা	ꯇꯥꯛꯂꯝꯕ
তাক্লি	ꯇꯥꯛꯂꯤ
তাক্লে	ꯇꯥꯛꯂꯦ
তাকয়েল	ꯇꯥꯛꯌꯦꯜ
তাকয়েলগী	ꯇꯥꯛꯌꯦꯜꯒꯤ
তাখি	ꯇꯥꯈꯤ
তাখিদনবা	ꯇꯥꯈꯤꯗꯟꯕꯥ
তাখিদুনা	ꯇꯥꯈꯤꯗꯨꯅꯥ
তাখিদে	ꯇꯥꯈꯤꯗꯦ
তাখিবনি	ꯇꯥꯈꯤꯕꯅꯤ
তাখিবা	ꯇꯥꯈꯤꯕ
তাখ্রবা	ꯇꯥꯈ꯭ꯔꯕ
তাখ্রে	ꯇꯥꯈ꯭ꯔꯦ
তাগনি	ꯇꯥꯒꯅꯤ
তাগী	ꯇꯥꯒꯤ
তাঙ্কক	ꯇꯥꯡꯀꯛ
তাঙ্ককশিংদা	ꯇꯥꯡꯀꯛꯁꯤꯡꯗ
তাঙ্ককী	ꯇꯥꯡꯀꯤ
তাঙ্কক্কী	ꯇꯥꯡꯀꯛꯀꯤ
তাঙ্খুল	ꯇꯥꯡꯈꯨꯜ
তাজ	ꯇꯥꯖ
তাজৈ	ꯇꯥꯖꯩ
তাঞ্জখিবা	ꯇꯥꯟꯖꯈꯤꯕ
তাঞ্জা	ꯇꯥꯟꯖꯥ
তাঞ্জাদা	ꯇꯥꯟꯖꯥꯗꯥ
তাথি	ꯇꯥꯊꯤ
তাথী	ꯇꯥꯊꯤ
তাদ	ꯇꯥꯗ
তাদনা	ꯇꯥꯗꯅ
তাদবা	ꯇꯥꯗꯕ
তাদা	ꯇꯥꯗ
তাদুনা	ꯇꯥꯗꯨꯅ
তাদে	ꯇꯥꯗꯦ
তাদ্রিঙৈদা	ꯇꯥꯗꯔꯤꯉꯩꯗꯥ
তাদ্রিবা	ꯇꯥꯗ꯭ꯔꯤꯕ
তাদ্রে	ꯇꯥꯗ꯭ꯔꯦ
তান	ꯇꯥꯅ
তানজা	ꯇꯥꯟꯖꯥ
তানদুনা	ꯇꯥꯟꯗꯨꯅ
তাননবা	ꯇꯥꯅꯅꯕ
তানফম	ꯇꯥꯟꯐꯝ
তানফমদা	ꯇꯥꯟꯐꯝꯗ
তানবগী	ꯇꯥꯟꯕꯒꯤ
তানবদা	ꯇꯥꯟꯕꯗ
তানবা	ꯇꯥꯟꯕ
তানরে	ꯇꯥꯅꯔꯦ
তানসু	ꯇꯥꯟꯁꯨ
তানা	ꯇꯥꯅ
তানিংবা	ꯇꯥꯅꯤꯡꯕ
তান্দুনা	ꯇꯥꯟꯗꯨꯅꯥ
তান্নখি	ꯇꯥꯟꯅꯈꯤ
তান্নদনা	ꯇꯥꯟꯅꯗꯅ
তান্নদবা	ꯇꯥꯟꯅꯗꯕ
তান্নদুনা	ꯇꯥꯟꯅꯗꯨꯅ
তান্নফম	ꯇꯥꯟꯅꯐꯝ
তান্নবগী	ꯇꯥꯟꯅꯕꯒꯤ
তান্নবদা	ꯇꯥꯟꯅꯕꯗ
তান্নবনা	ꯇꯥꯟꯅꯕꯅ
তান্নবা	ꯇꯥꯟꯅꯕ
তান্নরক্লে	ꯇꯥꯟꯅꯔꯛꯂꯦ
তান্নরগা	ꯇꯥꯟꯅꯔꯒ
তান্নরবা	ꯇꯥꯟꯅꯔꯕ
তান্নরমগদবনি	ꯇꯥꯟꯅꯔꯝꯒꯗꯕꯅꯤ
তান্নরি	ꯇꯥꯟꯅꯔꯤ
তান্নরে	ꯇꯥꯟꯅꯔꯦ
তান্না	ꯇꯥꯟꯅ
তাপ	ꯇꯥꯄ
তাবগা	ꯇꯥꯕꯒ
তাবগী	ꯇꯥꯕꯒꯤ
তাবদগী	ꯇꯥꯕꯗꯒꯤ
তাবদসু	ꯇꯥꯕꯗꯁꯨ
তাবদা	ꯇꯥꯕꯗ
তাবদু	ꯇꯥꯕꯗꯨ
তাবনা	ꯇꯥꯕꯅ
তাবনি	ꯇꯥꯕꯅꯤ
তাবমখৈ	ꯇꯥꯕꯝꯈꯩ
তাবসু	ꯇꯥꯕꯁꯨ
তাবা	ꯇꯥꯕ
তাবিরিবা	ꯇꯥꯕꯤꯔꯤꯕ
তাবিয়ু	ꯇꯥꯕꯤꯌꯨ
তাবু	ꯇꯥꯕꯨ
তামিন্নবগী	ꯇꯥꯃꯤꯟꯅꯕꯒꯤ
তামিন্নবা	ꯇꯥꯃꯤꯟꯅꯕ
তামিল	ꯇꯥꯃꯤꯜ
তামৈ	ꯇꯥꯃꯩ
তাম্না	ꯇꯥꯝꯅꯥ
তার	ꯇꯥꯔ
তারকই	ꯇꯥꯔꯛꯏ
তারকখিবা	ꯇꯥꯔꯛꯈꯤꯕꯥ
তারকপগী	ꯇꯥꯔꯛꯄꯒꯤ
তারকপদসু	ꯇꯥꯔꯛꯄꯗꯁꯨ
তারকপদা	ꯇꯥꯔꯛꯄꯗ
তারকপা	ꯇꯥꯔꯛꯄ
তারক্লবা	ꯇꯥꯔꯛꯂꯕꯥ
তারক্লি	ꯇꯥꯔꯛꯂꯤ
তারক্লে	ꯇꯥꯔꯛꯂꯦ
তারগদি	ꯇꯥꯔꯒꯗꯤ
তারগনা	ꯇꯥꯔꯒꯅꯥ
তারগসু	ꯇꯥꯔꯒꯁꯨ
তারগা	ꯇꯥꯔꯒ
তারদুনা	ꯇꯥꯔꯗꯨꯅꯥ
তারবদি	ꯇꯥꯔꯕꯗꯤ
তারবশিং	ꯇꯥꯔꯕꯁꯤꯡ
তারবশিংগী	ꯇꯥꯔꯕꯁꯤꯡꯒꯤ
তারবশিংগীদমক	ꯇꯥꯔꯕꯁꯤꯡꯒꯤꯗꯃꯛ
তারবশিংদা	ꯇꯥꯔꯕꯁꯤꯡꯗ
তারবসু	ꯇꯥꯔꯕꯁꯨ
তারবা	ꯇꯥꯔꯕ
তারমদাই	ꯇꯥꯔꯝꯗꯥꯢ
তারম্বা	ꯇꯥꯔꯝꯕꯥ
তারা	ꯇꯥꯔꯥ
তারি	ꯇꯥꯔꯤ
তারিক	ꯇꯥꯔꯤꯛ
তারিখ	ꯇꯥꯔꯤꯈ
তারিবা	ꯇꯥꯔꯤꯕ
তারু	ꯇꯥꯔꯨ
তারুবদা	ꯇꯥꯔꯨꯕꯗꯥ
তারে	ꯇꯥꯔꯦ
তালিবান	ꯇꯥꯂꯤꯕꯥꯟ
তালিবানগী	ꯇꯥꯂꯤꯕꯥꯟꯒꯤ
তালিবাননা	ꯇꯥꯂꯤꯕꯥꯟꯅ
তালুই	ꯇꯥꯂꯨꯢ
তাল্লক	ꯇꯥꯜꯂꯛ
তাল্লকপা	ꯇꯥꯜꯂꯛꯄ
তাল্লিবা	ꯇꯥꯜꯂꯤꯕ
তাশিন	ꯇꯥꯁꯤꯅ
তাশিনখিবা	ꯇꯥꯁꯤꯟꯈꯤꯕ
তাশিনবদগী	ꯇꯥꯁꯤꯟꯕꯗꯒꯤ
তাশিন্দুনা	ꯇꯥꯁꯤꯟꯗꯨꯅꯥ
তাহনখি	ꯇꯥꯍꯟꯈꯤ
তাহনগদবনি	ꯇꯥꯍꯟꯒꯗꯕꯅꯤ
তাহনবগী	ꯇꯥꯍꯟꯕꯒꯤ
তাহনবদা	ꯇꯥꯍꯟꯕꯗ
তাহনবনি	ꯇꯥꯍꯟꯕꯅꯤ
তাহনবা	ꯇꯥꯍꯟꯕ
তাহন্দুনা	ꯇꯥꯍꯟꯗꯨꯅ
তাহন্নবা	ꯇꯥꯍꯟꯅꯕ
তাহল্লি	ꯇꯥꯍꯜꯂꯤ
তাহল্লিবা	ꯇꯥꯍꯜꯂꯤꯕ
তাহল্লে	ꯇꯥꯍꯜꯂꯦ
তায়	ꯇꯥꯌ
তায়নবা	ꯇꯥꯢꯅꯕ
তি	ꯇꯤ
তিংদনা	ꯇꯤꯡꯗꯅ
তিংদবা	ꯇꯤꯡꯗꯕ
তিংদুনা	ꯇꯤꯡꯗꯨꯅ
তিংনা	ꯇꯤꯡꯅ
তিংলিবা	ꯇꯤꯡꯂꯤꯕ
তিক	ꯇꯤꯀ
তিকেন	ꯇꯤꯀꯦꯟ
তিজেন্দ্র	ꯇꯤꯖꯦꯟꯗ꯭ꯔ
তিঞ্জং	ꯇꯤꯟꯖꯪ
তিদিম	ꯇꯤꯗꯤꯝ
তিন	ꯇꯤꯟ
তিনখিবা	ꯇꯤꯟꯈꯤꯕ
তিনফম	ꯇꯤꯟꯐꯝ
তিনফমদা	ꯇꯤꯟꯐꯝꯗ
তিনবগী	ꯇꯤꯟꯕꯒꯤ
তিনবা	ꯇꯤꯟꯕ
তিন্দনবা	ꯇꯤꯟꯗꯅꯕ
তিন্দুনা	ꯇꯤꯟꯗꯨꯅꯥ
তিন্নদুনা	ꯇꯤꯟꯅꯗꯨꯅꯥ
তিন্ননা	ꯇꯤꯟꯅꯅꯥ
তিন্নবা	ꯇꯤꯟꯅꯕ
তিন্নরুবা	ꯇꯤꯟꯅꯔꯨꯕꯥ
তিন্না	ꯇꯤꯟꯅ
তিন্নৈ	ꯇꯤꯟꯅꯩ
তিবেতান	ꯇꯤꯕꯦꯠꯅ
তিল	ꯇꯤꯜ
তিলহন্নবা	ꯇꯤꯜꯍꯟꯅꯕ
তিল্লগা	ꯇꯤꯜꯂꯒ
তিল্লনি	ꯇꯤꯜꯂꯅꯤ
তিল্লবা	ꯇꯤꯜꯂꯕ
তিল্লিবা	ꯇꯤꯜꯂꯤꯕ
তিৱারি	ꯇꯤꯋꯥꯔꯤ
তীন	ꯇꯤꯅ
তু	ꯇꯨ
তুং	ꯇꯨꯡ
তুংইনবা	ꯇꯨꯡꯏꯟꯕ
তুংইন্না	ꯇꯨꯡꯏꯟꯅ
তুংওইনরম্লগা	ꯇꯨꯡꯑꯣꯏꯅꯔꯝꯂꯒ
তুংগী	ꯇꯨꯡꯒꯤ
তুংদসু	ꯇꯨꯡꯗꯁꯨ
তুংদা	ꯇꯨꯡꯗ
তুজুং	ꯇꯨꯖꯨꯡ
তুজুংবা	ꯇꯨꯖꯨꯡꯕ
তুদনা	ꯇꯨꯗꯅ
তুনা	ꯇꯨꯅꯥ
তুপুল	ꯇꯨꯄꯨꯜ
তুপ্পা	ꯇꯨꯞꯄꯥ
তুবা	ꯇꯨꯕ
তুমখৎলক্লিবা	ꯇꯨꯝꯈꯠꯂꯛꯂꯤꯕ
তুমদনা	ꯇꯨꯝꯗꯅ
তুমদবা	ꯇꯨꯝꯗꯕ
তুমিন	ꯇꯨꯃꯤꯅ
তুমিন্না	ꯇꯨꯃꯤꯟꯅ
তুম্না	ꯇꯨꯝꯅ
তুম্বা	ꯇꯨꯝꯕ
তুম্লম্বদগী	ꯇꯨꯝꯂꯝꯕꯗꯒꯤ
তুম্লিঙৈদা	ꯇꯨꯝꯂꯤꯉꯩꯗꯥ
তুরগা	ꯇꯨꯔꯒ
তুরান	ꯇꯨꯔꯥꯅ
তুরে	ꯇꯨꯔꯦ
তুরেল	ꯇꯨꯔꯦꯜ
তুরেলগী	ꯇꯨꯔꯦꯜꯒꯤ
তুরেলদা	ꯇꯨꯔꯦꯜꯗ
তুরেলশিং	ꯇꯨꯔꯦꯜꯁꯤꯡ
তুরেলশিংদা	ꯇꯨꯔꯦꯜꯁꯤꯡꯗ
তুহৎ	ꯇꯨꯍꯠ
তুহৎপীরবা	ꯇꯨꯍꯠꯄꯤꯔꯕ
তুয়েনশাং	ꯇꯨꯌꯦꯟꯁꯥꯡ
তূমিন্না	ꯇꯨꯃꯤꯟꯅꯥ
তূম্ফম	ꯇꯨꯝꯐꯝ
তূম্বা	ꯇꯨꯝꯕꯥ
তেংথা	ꯇꯦꯪꯊꯥ
তেংনবা	ꯇꯦꯪꯅꯕꯥ
তেংবাং	ꯇꯦꯡꯕꯥꯡ
তেংবাংখ্রে	ꯇꯦꯡꯕꯥꯡꯈ꯭ꯔꯦ
তেংবাংগী	ꯇꯦꯡꯕꯥꯡꯒꯤ
তেংবাংনদুনা	ꯇꯦꯡꯕꯥꯡꯅꯗꯨꯅ
তেংবাংনবগী	ꯇꯦꯡꯕꯥꯡꯅꯕꯒꯤ
তেক	ꯇꯦꯛ
তেকখিবদগী	ꯇꯦꯛꯈꯤꯕꯗꯒꯤ
তেখাও	ꯇꯦꯈꯥꯑꯣ
তেগ	ꯇꯦꯒ
তেনখ্রবা	ꯇꯦꯟꯈ꯭ꯔꯕ
তেনজিং	ꯇꯦꯟꯖꯤꯡ
তেনবা	ꯇꯦꯟꯕ
তেন্থা	ꯇꯦꯟꯊꯥ
তেন্থাগী	ꯇꯦꯟꯊꯥꯒꯤ
তেন্থাদা	ꯇꯦꯟꯊꯥꯗ
তেন্না	ꯇꯦꯟꯅꯥ
তেপ	ꯇꯦꯄ
তেরা	ꯇꯦꯔꯥ
তেরি	ꯇꯦꯔꯤ
তেলঙ্গনা	ꯇꯦꯂꯡꯒꯅꯥ
তেলঙ্গনাগী	ꯇꯦꯂꯡꯒꯅꯥꯒꯤ
তেলঙ্গনাদগী	ꯇꯦꯂꯡꯒꯅꯥꯗꯒꯤ
তেলঙ্গনাদা	ꯇꯦꯂꯡꯒꯅꯥꯗ
তেল্লবা	ꯇꯦꯜꯂꯕ
তৈনবদা	ꯇꯩꯅꯕꯗ
তৈনবা	ꯇꯩꯅꯕ
তৈবা	ꯇꯩꯕꯥ
তৈশিন্দুনা	ꯇꯩꯁꯤꯟꯗꯨꯅꯥ
ত্বিটরদা	ꯇ꯭ꯋꯤꯇꯔꯗꯥ
ত্বিতর	ꯇ꯭ꯋꯤꯇꯔ
ত্বিতরদা	ꯇ꯭ꯋꯤꯇꯔꯗꯥ
তৎখিবদগী	ꯇꯠꯈꯤꯕꯗꯒꯤ
তৎখিবা	ꯇꯠꯈꯤꯕꯥ
তৎতনা	ꯇꯠꯇꯅꯥ
তৎতুনা	ꯇꯠꯇꯨꯅꯥ
তৎন	ꯇꯠꯅ
তৎপদগী	ꯇꯠꯄꯗꯒꯤ
তয়াম্না	ꯇꯌꯥꯝꯅꯥ
তয়াল	ꯇꯌꯥꯂ
থংদুনা	ꯊꯪꯗꯨꯅꯥ
থংন	ꯊꯪꯅ
থংননা	ꯊꯪꯅꯅꯥ
থংনবদা	ꯊꯪꯅꯕꯗꯥ
থংনবা	ꯊꯪꯅꯕꯥ
থংনা	ꯊꯪꯅꯥ
থংবদা	ꯊꯪꯕꯗꯥ
থংবা	ꯊꯪꯕꯥ
থওই	ꯊꯑꯣꯏ
থওইদনা	ꯊꯑꯣꯏꯗꯅꯥ
থওইদবগী	ꯊꯑꯣꯏꯗꯕꯒꯤ
থওইদবা	ꯊꯑꯣꯏꯗꯕꯥ
থক	ꯊꯛ
থকপা	ꯊꯛꯄꯥ
থকমিন্নবা	ꯊꯛꯃꯤꯟꯅꯕꯥ
থকশি	ꯊꯛꯁꯤ
থকসি	ꯊꯛꯁꯤ
থক্কদবনি	ꯊꯛꯀꯗꯕꯅꯤ
থক্নবা	ꯊꯛꯅꯕꯥ
থঙ্গাল	ꯊꯡꯒꯥꯜ
থত্তুনা	ꯊꯠꯇꯨꯅꯥ
থদৎনবা	ꯊꯗꯠꯅꯕꯥ
থনবা	ꯊꯟꯕꯥ
থনম্বনি	ꯊꯅꯝꯕꯅꯤ
থনম্বা	ꯊꯅꯝꯕꯥ
থনম্মী	ꯊꯅꯝꯃꯤ
থনম্লগা	ꯊꯅꯝꯂꯒꯥ
থন্না	ꯊꯟꯅꯥ
থবক	ꯊꯕꯛ
থবকনা	ꯊꯕꯛꯅꯥ
থবকনি	ꯊꯕꯛꯅꯤ
থবকশিং	ꯊꯕꯛꯁꯤꯡ
থবকশিংগী	ꯊꯕꯛꯁꯤꯡꯒꯤ
থবকশিংদা	ꯊꯕꯛꯁꯤꯡꯗꯥ
থবকশিংনা	ꯊꯕꯛꯁꯤꯡꯅꯥ
থবকশিংবু	ꯊꯕꯛꯁꯤꯡꯕꯨ
থবকশিংসু	ꯊꯕꯛꯁꯤꯡꯁꯨ
থবকসু	ꯊꯕꯛꯁꯨ
থবক্কা	ꯊꯕꯛꯀꯥ
থবক্কী	ꯊꯕꯛꯀꯤ
থবক্কীদমক	ꯊꯕꯛꯀꯤꯗꯃꯛ
থবক্না	ꯊꯕꯛꯅꯥ
থবক্নি	ꯊꯕꯛꯅꯤ
থবাক	ꯊꯕꯥꯛ
থমখি	ꯊꯝꯈꯤ
থমখিগনি	ꯊꯝꯈꯤꯒꯅꯤ
থমখিদে	ꯊꯝꯈꯤꯗꯦ
থমখিবগা	ꯊꯝꯈꯤꯕꯒꯥ
থমখিবগী	ꯊꯝꯈꯤꯕꯒꯤ
থমখিবদগী	ꯊꯝꯈꯤꯕꯗꯒꯤ
থমখিবনা	ꯊꯝꯈꯤꯕꯅꯥ
থমখিবনি	ꯊꯝꯈꯤꯕꯅꯤ
থমখিবা	ꯊꯝꯈꯤꯕꯥ
থমখ্রবনি	ꯊꯝꯈ꯭ꯔꯕꯅꯤ
থমখ্রে	ꯊꯝꯈ꯭ꯔꯦ
থমগদবনি	ꯊꯝꯒꯗꯕꯅꯤ
থমগনি	ꯊꯝꯒꯅꯤ
থমজিনখি	ꯊꯝꯖꯤꯟꯈꯤ
থমজিনখ্রে	ꯊꯝꯖꯤꯟꯈꯔꯦ
থমজিনবা	ꯊꯝꯖꯤꯟꯕꯥ
থমজিল্লিবা	ꯊꯝꯖꯤꯜꯂꯤꯕꯥ
থমদনা	ꯊꯝꯗꯅꯥ
থমদবা	ꯊꯝꯗꯕꯥ
থমদুনা	ꯊꯝꯗꯨꯅꯥ
থমদে	ꯊꯝꯗꯦ
থমসি	ꯊꯝꯁꯤ
থম্ননবা	ꯊꯝꯅꯅꯕꯥ
থম্নবগী	ꯊꯝꯅꯕꯒꯤ
থম্নবগীদমক	ꯊꯝꯅꯕꯒꯤꯗꯃꯛ
থম্নবসু	ꯊꯝꯅꯕꯁꯨ
থম্নবা	ꯊꯝꯅꯕꯥ
থম্না	ꯊꯝꯅꯥ
থম্ফম	ꯊꯝꯐꯝ
থম্বগা	ꯊꯝꯕꯒꯥ
থম্বগী	ꯊꯝꯕꯒꯤ
থম্বতা	ꯊꯝꯕꯇꯥ
থম্বদগী	ꯊꯝꯕꯗꯒꯤ
থম্বদা	ꯊꯝꯕꯗꯥ
থম্বনচিংবা	ꯊꯝꯕꯅꯆꯤꯡꯕꯥ
থম্বনা	ꯊꯝꯕꯅꯥ
থম্বনি	ꯊꯝꯕꯅꯤ
থম্বা	ꯊꯝꯕꯥ
থম্বাল	ꯊꯝꯕꯥꯜ
থম্বালনু	ꯊꯝꯕꯥꯜꯅꯨ
থম্বীনবা	ꯊꯝꯕꯤꯅꯕꯥ
থম্বীবা	ꯊꯝꯕꯤꯕꯥ
থম্বীরম্বা	ꯊꯝꯕꯤꯔꯝꯕꯥ
থম্বীরম্মী	ꯊꯝꯕꯤꯔꯝꯃꯤ
থম্বীরি	ꯊꯝꯕꯤꯔꯤ
থম্বীয়ু	ꯊꯝꯕꯤꯌꯨ
থম্মী	ꯊꯝꯃꯤ
থম্মু	ꯊꯝꯃꯨ
থম্লকখি	ꯊꯝꯂꯛꯈꯤ
থম্লকখিবনি	ꯊꯝꯂꯛꯈꯤꯕꯅꯤ
থম্লকখিবা	ꯊꯝꯂꯛꯈꯤꯕꯥ
থম্লকপগী	ꯊꯝꯂꯛꯄꯒꯤ
থম্লকপদা	ꯊꯝꯂꯛꯄꯗꯥ
থম্লকপনি	ꯊꯝꯂꯛꯄꯅꯤ
থম্লকপা	ꯊꯝꯂꯛꯄꯥ
থম্লক্লি	ꯊꯝꯂꯛꯂꯤ
থম্লক্লিবা	ꯊꯝꯂꯛꯂꯤꯕꯥ
থম্লক্লে	ꯊꯝꯂꯛꯂꯦ
থম্লগনি	ꯊꯝꯂꯒꯅꯤ
থম্লগা	ꯊꯝꯂꯒꯥ
থম্লবদি	ꯊꯝꯂꯕꯗꯤ
থম্লবসু	ꯊꯝꯂꯕꯁꯨ
থম্লবা	ꯊꯝꯂꯕꯥ
থম্লম্বনি	ꯊꯝꯂꯝꯕꯅꯤ
থম্লম্বশিং	ꯊꯝꯂꯝꯕꯁꯤꯡ
থম্লম্বা	ꯊꯝꯂꯝꯕꯥ
থম্লম্মী	ꯊꯝꯂꯝꯃꯤ
থম্লম্লগা	ꯊꯝꯂꯝꯂꯒꯥ
থম্লি	ꯊꯝꯂꯤ
থম্লিবশিং	ꯊꯝꯂꯤꯕꯁꯤꯡ
থম্লিবা	ꯊꯝꯂꯤꯕꯥ
থম্লুরবা	ꯊꯝꯂꯨꯔꯕꯥ
থম্লে	ꯊꯝꯂꯦ
থর্মেল	ꯊ꯭ꯔꯃꯦꯜ
থল্লবা	ꯊꯜꯂꯕꯥ
থল্লম্মী	ꯊꯜꯂꯝꯃꯤ
থল্লি	ꯊꯜꯂꯤ
থল্লে	ꯊꯜꯂꯦ
থা	ꯊꯥ
থাং	ꯊꯥꯡ
থাংগৎলকপা	ꯊꯥꯡꯒꯠꯂꯛꯄꯥ
থাংজ	ꯊꯥꯡꯖ
থাংজগী	ꯊꯥꯡꯖꯒꯤ
থাংজদা	ꯊꯥꯡꯖꯗꯥ
থাংজম	ꯊꯥꯡꯖꯝ
থাংজমনা	ꯊꯥꯡꯖꯝꯅꯥ
থাংজা	ꯊꯥꯪꯖꯥ
থাংজিনবা	ꯊꯥꯡꯖꯤꯟꯕꯥ
থাংবা	ꯊꯥꯡꯕꯥ
থাংমৈবন্দ	ꯊꯥꯡꯃꯩꯕꯟꯗ
থাংমৈবন্দগী	ꯊꯥꯡꯃꯩꯕꯟꯗꯒꯤ
থাংমৈবন্দদগী	ꯊꯥꯡꯃꯩꯕꯟꯗꯗꯒꯤ
থাংমৈবন্দদা	ꯊꯥꯡꯃꯩꯕꯟꯗꯗꯥ
থাইনগী	ꯊꯥꯏꯅꯒꯤ
থাইনদগী	ꯊꯥꯏꯅꯗꯒꯤ
থাইনা	ꯊꯥꯏꯅꯥ
থাইমৈ	ꯊꯥꯏꯃꯩ
থাইলেন্দ	ꯊꯥꯏꯂꯦꯟꯗ
থাইলেন্দগী	ꯊꯥꯏꯂꯦꯟꯗꯒꯤ
থাইলেন্দদা	ꯊꯥꯏꯂꯦꯟꯗꯗꯥ
থাও	ꯊꯥꯎ
থাক	ꯊꯥꯛ
থাকসি	ꯊꯥꯛꯁꯤ
থাকুর	ꯊꯥꯀꯨꯔ
থাক্কা	ꯊꯥꯛꯀꯥ
থাক্কী	ꯊꯥꯛꯀꯤ
থাক্রে	ꯊꯥꯛꯇ꯭ꯔꯦ
থাক্লবা	ꯊꯥꯛꯂꯕꯥ
থাক্লম্বা	ꯊꯥꯛꯂꯝꯕꯥ
থাখি	ꯊꯥꯈꯤ
থাখিবগী	ꯊꯥꯈꯤꯕꯒꯤ
থাখিবনি	ꯊꯥꯈꯤꯕꯅꯤ
থাখিবশিং	ꯊꯥꯈꯤꯕꯁꯤꯡ
থাখিবা	ꯊꯥꯈꯤꯕꯥ
থাখ্রবনি	ꯊꯥꯈ꯭ꯔꯕꯅꯤ
থাখ্রে	ꯊꯥꯈ꯭ꯔꯦ
থাগদবনি	ꯊꯥꯒꯗꯕꯅꯤ
থাগদবা	ꯊꯥꯒꯗꯕꯥ
থাগনি	ꯊꯥꯒꯅꯤ
থাগা	ꯊꯥꯒꯥ
থাগী	ꯊꯥꯒꯤ
থাগে	ꯊꯥꯒꯦ
থাগৎ	ꯊꯥꯒꯠ
থাগৎকনি	ꯊꯥꯒꯠꯀꯅꯤ
থাগৎখি	ꯊꯥꯒꯠꯈꯤ
থাগৎখিবা	ꯊꯥꯒꯠꯈꯤꯕꯥ
থাগৎখ্রে	ꯊꯥꯒꯠꯈ꯭ꯔꯦ
থাগৎচরি	ꯊꯥꯒꯠꯆꯔꯤ
থাগৎতুনা	ꯊꯥꯒꯠꯇꯨꯅꯥ
থাগৎনিংঙাই	ꯊꯥꯒꯠꯅꯤꯡꯉꯥꯏ
থাগৎনিংঙাইনি	ꯊꯥꯒꯠꯅꯤꯡꯉꯥꯏꯅꯤ
থাগৎপ	ꯊꯥꯒꯠꯄ
থাগৎপগা	ꯊꯥꯒꯠꯄꯒꯥ
থাগৎপদা	ꯊꯥꯒꯠꯄꯗꯥ
থাগৎপসু	ꯊꯥꯒꯠꯄꯁꯨ
থাগৎপা	ꯊꯥꯒꯠꯄꯥ
থাগৎলকখিবনি	ꯊꯥꯒꯠꯂꯛꯈꯤꯕꯅꯤ
থাগৎলকপা	ꯊꯥꯒꯠꯂꯛꯄꯥ
থাগৎলদুনা	ꯊꯥꯒꯠꯂꯗꯨꯅꯥ
থাগৎলি	ꯊꯥꯒꯠꯂꯤ
থাগৎলিবা	ꯊꯥꯒꯠꯂꯤꯕꯥ
থাঙ	ꯊꯥꯉ
থাঙানা	ꯊꯥꯉꯥꯅꯥ
থাঙ্গ	ꯊꯥꯡꯒ
থাঙ্গগী	ꯊꯥꯡꯒꯒꯤ
থাঙ্গপাৎ	ꯊꯥꯡꯒꯄꯥꯠ
থাঙ্গাল	ꯊꯥꯡꯒꯥꯜ
থাঙ্গৎখ্রে	ꯊꯥꯡꯒꯠꯈ꯭ꯔꯦ
থাঙ্গৎতুনা	ꯊꯥꯡꯒꯠꯇꯨꯅꯥ
থাঙ্গৎলকপা	ꯊꯥꯡꯒꯠꯂꯛꯄꯥ
থাজখি	ꯊꯥꯖꯈꯤ
থাজদনা	ꯊꯥꯖꯗꯅꯥ
থাজদবগী	ꯊꯥꯖꯗꯕꯒꯤ
থাজদবা	ꯊꯥꯖꯗꯕꯥ
থাজদুনা	ꯊꯥꯖꯗꯨꯅꯥ
থাজদে	ꯊꯥꯖꯗꯦ
থাজনবগী	ꯊꯥꯖꯟꯕꯒꯤ
থাজনবা	ꯊꯥꯖꯟꯕꯥ
থাজনরি	ꯊꯥꯖꯅꯔꯤ
থাজনরিবা	ꯊꯥꯖꯅꯔꯤꯕꯥ
থাজনা	ꯊꯥꯖꯅꯥ
থাজনিংঙাই	ꯊꯥꯖꯅꯤꯡꯉꯥꯏ
থাজবগা	ꯊꯥꯖꯕꯒꯥ
থাজবগী	ꯊꯥꯖꯕꯒꯤ
থাজবনি	ꯊꯥꯖꯕꯅꯤ
থাজবশিং	ꯊꯥꯖꯕꯁꯤꯡ
থাজবসি	ꯊꯥꯖꯕꯁꯤ
থাজবসু	ꯊꯥꯖꯕꯁꯨ
থাজবা	ꯊꯥꯖꯕꯥ
থাজরিবা	ꯊꯥꯖꯔꯤꯕꯥ
থাজহনবা	ꯊꯥꯖꯍꯟꯕꯥ
থাজা	ꯊꯥꯖꯥ
থাজিনখ্রবা	ꯊꯥꯖꯤꯅꯈ꯭ꯔꯕꯥ
থাজিনখ্রে	ꯊꯥꯖꯤꯅꯈ꯭ꯔꯦ
থাজিনবগী	ꯊꯥꯖꯤꯅꯕꯒꯤ
থাজিনবা	ꯊꯥꯖꯤꯅꯕꯥ
থাজিন্দুনা	ꯊꯥꯖꯤꯟꯗꯨꯅꯥ
থাজিল্লগনি	ꯊꯥꯖꯤꯜꯂꯒꯅꯤ
থাজিল্লে	ꯊꯥꯖꯤꯜꯂꯦ
থাজৈ	ꯊꯥꯖꯩ
থাদখি	ꯊꯥꯗꯈꯤ
থাদখিবা	ꯊꯥꯗꯈꯤꯕꯥ
থাদখ্রে	ꯊꯥꯗꯈꯔꯦ
থাদগদবনি	ꯊꯥꯗꯒꯗꯕꯅꯤ
থাদগী	ꯊꯥꯗꯒꯤ
থাদদি	ꯊꯥꯗꯗꯤ
থাদদুনা	ꯊꯥꯗꯗꯨꯅꯥ
থাদনখি	ꯊꯥꯗꯅꯈꯤ
থাদনখিবা	ꯊꯥꯗꯅꯈꯤꯕꯥ
থাদনখ্রে	ꯊꯥꯗꯅꯈ꯭ꯔꯦ
থাদনগদবা	ꯊꯥꯗꯅꯒꯗꯕꯥ
থাদনগনি	ꯊꯥꯗꯅꯒꯅꯤ
থাদনবগা	ꯊꯥꯗꯅꯕꯒꯥ
থাদনবগী	ꯊꯥꯗꯅꯕꯒꯤ
থাদনবা	ꯊꯥꯗꯅꯕꯥ
থাদনরগনি	ꯊꯥꯗꯅꯔꯒꯅꯤ
থাদনরবা	ꯊꯥꯗꯅꯔꯕꯥ
থাদনা	ꯊꯥꯗꯅꯥ
থাদনি	ꯊꯥꯗꯅꯤ
থাদফম	ꯊꯥꯗꯐꯝ
থাদবগী	ꯊꯥꯗꯕꯒꯤ
থাদবদা	ꯊꯥꯗꯕꯗꯥ
থাদবা	ꯊꯥꯗꯕꯥ
থাদরকখি	ꯊꯥꯗꯔꯛꯈꯤ
থাদরকপদা	ꯊꯥꯗꯔꯛꯄꯗꯥ
থাদরকপা	ꯊꯥꯗꯔꯛꯄꯥ
থাদরক্লগা	ꯊꯥꯗꯔꯛꯂꯒꯥ
থাদরগা	ꯊꯥꯗꯔꯒꯥ
থাদরবা	ꯊꯥꯗꯔꯕꯥ
থাদরম্লগা	ꯊꯥꯗꯔꯝꯂꯒꯥ
থাদরিবা	ꯊꯥꯗꯔꯤꯕꯥ
থাদরে	ꯊꯥꯗꯔꯦ
থাদহন্নবা	ꯊꯥꯗꯍꯟꯅꯕꯥ
থাদা	ꯊꯥꯗꯥ
থাদুনা	ꯊꯥꯗꯨꯅꯥ
থাদ্রবদি	ꯊꯥꯗ꯭ꯔꯕꯗꯤ
থাননবা	ꯊꯥꯅꯅꯕꯥ
থানবগী	ꯊꯥꯅꯕꯒꯤ
থানবা	ꯊꯥꯅꯕꯥ
থানা	ꯊꯥꯅꯥ
থানিংবা	ꯊꯥꯅꯤꯡꯕꯥ
থান্দুনা	ꯊꯥꯟꯗꯨꯅꯥ
থাপ্না	ꯊꯥꯞꯅꯥ
থাপ্লবা	ꯊꯥꯄꯂꯕꯥ
থাবগা	ꯊꯥꯕꯒꯥ
থাবগী	ꯊꯥꯕꯒꯤ
থাবদগী	ꯊꯥꯕꯗꯒꯤ
থাবদা	ꯊꯥꯕꯗꯥ
থাবনচিংবা	ꯊꯥꯕꯅꯆꯤꯡꯕꯥ
থাবনা	ꯊꯥꯕꯅꯥ
থাবল	ꯊꯥꯕꯜ
থাবা	ꯊꯥꯕꯥ
থাবু	ꯊꯥꯕꯨ
থাবুম	ꯊꯥꯕꯨꯝ
থারকখি	ꯊꯥꯔꯛꯈꯤ
থারকখিবা	ꯊꯥꯔꯛꯈꯤꯕꯥ
থারকপা	ꯊꯥꯔꯛꯄꯥ
থারক্নবা	ꯊꯥꯔꯛꯅꯕꯥ
থারগনি	ꯊꯥꯔꯒꯅꯤ
থারগা	ꯊꯥꯔꯒꯥ
থারদুনা	ꯊꯥꯔꯗꯨꯅꯥ
থারবসু	ꯊꯥꯔꯕꯁꯨ
থারবা	ꯊꯥꯔꯕꯥ
থারম্বা	ꯊꯥꯔꯝꯕꯥ
থারি	ꯊꯥꯔꯤ
থারিবনি	ꯊꯥꯔꯤꯕꯅꯤ
থারিবা	ꯊꯥꯔꯤꯕꯥ
থারে	ꯊꯥꯔꯦ
থার্দ	ꯊꯥꯔꯗ
থি	ꯊꯤ
থিংখি	ꯊꯤꯡꯈꯤ
থিংখিগনি	ꯊꯤꯡꯈꯤꯒꯅꯤ
থিংখিবনি	ꯊꯤꯡꯈꯤꯕꯅꯤ
থিংখিবা	ꯊꯤꯪꯈꯤꯕꯥ
থিংখ্রবা	ꯊꯤꯡꯈ꯭ꯔꯕꯥ
থিংখ্রে	ꯊꯤꯡꯈꯔꯦ
থিংগদবনি	ꯊꯤꯡꯒꯗꯕꯅꯤ
থিংগনি	ꯊꯤꯡꯒꯅꯤ
থিংজিনখি	ꯊꯤꯡꯖꯤꯟꯈꯤ
থিংজিনখিবদগী	ꯊꯤꯡꯖꯤꯟꯈꯤꯕꯗꯒꯤ
থিংজিনখিবনি	ꯊꯤꯡꯖꯤꯟꯈꯤꯕꯅꯤ
থিংজিনখ্রে	ꯊꯤꯡꯖꯤꯅꯈꯔꯦ
থিংজিনবগা	ꯊꯤꯡꯖꯤꯟꯕꯒꯥ
থিংজিনবা	ꯊꯤꯡꯖꯤꯟꯕꯥ
থিংজিন্দুনা	ꯊꯤꯪꯖꯤꯟꯗꯨꯅꯥ
থিংজিন্নবা	ꯊꯤꯡꯖꯤꯟꯅꯕꯥ
থিংজিল্লকপা	ꯊꯤꯡꯖꯤꯜꯂꯛꯄꯥ
থিংজিল্লুরবা	ꯊꯤꯡꯖꯤꯜꯂꯨꯔꯕꯥ
থিংজিল্লে	ꯊꯤꯡꯖꯤꯜꯂꯦ
থিংদুনা	ꯊꯤꯡꯗꯨꯅꯥ
থিংননবগী	ꯊꯤꯡꯅꯅꯕꯒꯤ
থিংননবা	ꯊꯤꯡꯅꯅꯕꯥ
থিংনবগী	ꯊꯤꯡꯅꯕꯒꯤ
থিংনবগীদমক	ꯊꯤꯡꯅꯕꯒꯤꯗꯃꯛ
থিংনবা	ꯊꯤꯡꯅꯕꯥ
থিংবগী	ꯊꯤꯡꯕꯒꯤ
থিংবদা	ꯊꯤꯡꯕꯗꯥ
থিংবা	ꯊꯤꯡꯕꯥ
থিংলগনি	ꯊꯤꯡꯂꯒꯅꯤ
থিংলগা	ꯊꯤꯡꯂꯒꯥ
থিংলসি	ꯊꯤꯡꯂꯁꯤ
থিংলে	ꯊꯤꯡꯂꯦ
থিংসি	ꯊꯤꯡꯁꯤ
থিওরি	ꯊꯤꯑꯣꯔꯤ
থিখি	ꯊꯤꯈꯤ
থিগনি	ꯊꯤꯒꯅꯤ
থিগৎনবা	ꯊꯤꯒꯠꯅꯕꯥ
থিগৎপগী	ꯊꯤꯒꯠꯄꯒꯤ
থিগৎপা	ꯊꯤꯒꯠꯄꯥ
থিঙমদনা	ꯊꯤꯉꯝꯗꯅꯥ
থিঙমদ্রবা	ꯊꯤꯉꯝꯗ꯭ꯔꯕꯥ
থিঙ্কিং	ꯊꯤꯡꯀꯤꯡ
থিজিন	ꯊꯤꯖꯤꯟ
থিজিনবগী	ꯊꯤꯖꯤꯟꯕꯒꯤ
থিজিনবদা	ꯊꯤꯖꯤꯟꯕꯗꯥ
থিজিনবা	ꯊꯤꯖꯤꯟꯕꯥ
থিজিন্নবা	ꯊꯤꯖꯤꯟꯅꯕꯥ
থিজিল্লি	ꯊꯤꯖꯤꯜꯂꯤ
থিজিল্লিবা	ꯊꯤꯖꯤꯜꯂꯤꯕꯥ
থিজিল্লুবা	ꯊꯤꯖꯤꯜꯂꯨꯕꯥ
থিদনা	ꯊꯤꯗꯅꯥ
থিদুনা	ꯊꯤꯗꯨꯅꯥ
থিন	ꯊꯤꯟ
থিনখ্রে	ꯊꯤꯟꯈꯔꯦ
থিননবা	ꯊꯤꯅꯅꯕꯥ
থিনবগী	ꯊꯤꯅꯕꯒꯤ
থিনবদা	ꯊꯤꯅꯕꯗꯥ
থিনবা	ꯊꯤꯅꯕꯥ
থিনা	ꯊꯤꯅꯥ
থিন্থবা	ꯊꯤꯟꯊꯕꯥ
থিন্থহল্লে	ꯊꯤꯟꯊꯍꯜꯂꯦ
থিন্দুনা	ꯊꯤꯟꯗꯨꯅꯥ
থিন্নবা	ꯊꯤꯟꯅꯕꯥ
থিবগী	ꯊꯤꯕꯒꯤ
থিবদগী	ꯊꯤꯕꯗꯒꯤ
থিবদা	ꯊꯤꯕꯗꯥ
থিবদি	ꯊꯤꯕꯗꯤ
থিবনি	ꯊꯤꯕꯅꯤ
থিবা	ꯊꯤꯕꯥ
থিম	ꯊꯤꯝ
থিমদি	ꯊꯤꯝꯗꯤ
থিরক্লে	ꯊꯤꯔꯛꯂꯦ
থিরগনি	ꯊꯤꯔꯒꯅꯤ
থিরগা	ꯊꯤꯔꯒꯥ
থিরদুনা	ꯊꯤꯔꯗꯨꯅꯥ
থিরবসু	ꯊꯤꯔꯕꯁꯨ
থিরবা	ꯊꯤꯔꯕꯥ
থিরি	ꯊꯤꯔꯤ
থিরিবা	ꯊꯤꯔꯤꯕꯥ
থিরুবদা	ꯊꯤꯔꯨꯕꯗꯥ
থিরুসি	ꯊꯤꯔꯨꯁꯤ
থিরে	ꯊꯤꯔꯦ
থিল্লগা	ꯊꯤꯜꯂꯒꯥ
থিল্লম্লগা	ꯊꯤꯜꯂꯝꯂꯒꯥ
থিল্লু	ꯊꯤꯜꯂꯨ
থিহনখি	ꯊꯤꯍꯟꯈꯤ
থিহনখ্রে	ꯊꯤꯍꯟꯈꯔꯦ
থিহনগনি	ꯊꯤꯍꯟꯒꯅꯤ
থিহনবগী	ꯊꯤꯍꯟꯕꯒꯤ
থিহনবনচিংবা	ꯊꯤꯍꯟꯕꯅꯆꯤꯡꯕꯥ
থিহন্দুনা	ꯊꯤꯍꯟꯗꯨꯅꯥ
থিহন্নবা	ꯊꯤꯍꯟꯅꯕꯥ
থিহল্লিবা	ꯊꯤꯍꯜꯂꯤꯕꯥ
থিয়াম	ꯊꯤꯌꯥꯝ
থিয়েটর	ꯊꯤꯌꯦꯇꯔ
থিয়েটরগী	ꯊꯤꯌꯦꯇꯔꯒꯤ
থীদুনা	ꯊꯤꯗꯨꯅꯥ
থীনা	ꯊꯤꯅꯥ
থীবদি	ꯊꯤꯕꯗꯤ
থীবা	ꯊꯤꯕꯥ
থীবী	ꯊꯤꯕꯤ
থীরবা	ꯊꯤꯔꯕꯥ
থীরবী	ꯊꯤꯔꯕꯤ
থুংখি	ꯊꯨꯡꯈꯤ
থুংখিবা	ꯊꯨꯡꯈꯤꯕꯥ
থুংদবা	ꯊꯨꯡꯗꯕꯥ
থুংদুনা	ꯊꯨꯪꯗꯨꯅꯥ
থুংননবা	ꯊꯨꯪꯅꯟꯕꯥ
থুংনবা	ꯊꯨꯡꯅꯕꯥ
থুংনা	ꯊꯨꯡꯅꯥ
থুংবগী	ꯊꯨꯡꯕꯒꯤ
থুংবদা	ꯊꯨꯡꯕꯗꯥ
থুংবা	ꯊꯨꯡꯕꯥ
থুংলখি	ꯊꯨꯡꯂꯈꯤ
থুংলখিবা	ꯊꯨꯡꯂꯈꯤꯕꯥ
থুংলগনি	ꯊꯨꯡꯂꯒꯅꯤ
থুংলদুনা	ꯊꯨꯡꯂꯗꯨꯅꯥ
থুংলবগা	ꯊꯨꯡꯂꯕꯒꯥ
থুংলবদা	ꯊꯨꯡꯂꯕꯗꯥ
থুংলবনি	ꯊꯨꯡꯂꯕꯅꯤ
থুংলবা	ꯊꯨꯡꯂꯕꯥ
থুংলরগা	ꯊꯨꯡꯂꯔꯒꯥ
থুংলরবা	ꯊꯨꯡꯂꯔꯕꯥ
থুংলরে	ꯊꯨꯡꯂꯔꯦ
থুংহনবা	ꯊꯨꯡꯍꯟꯕꯥ
থুক	ꯊꯨꯛ
থুগাই	ꯊꯨꯒꯥꯏ
থুগাইখিবনি	ꯊꯨꯒꯥꯏꯈꯤꯕꯅꯤ
থুগাইদুনা	ꯊꯨꯒꯥꯏꯗꯨꯅꯥ
থুগাইনবা	ꯊꯨꯒꯥꯏꯅꯕꯥ
থুগাইবগী	ꯊꯨꯒꯥꯏꯕꯒꯤ
থুগাইবশিং	ꯊꯨꯒꯥꯏꯕꯁꯤꯡ
থুগাইবা	ꯊꯨꯒꯥꯏꯕꯥ
থুগাইরগা	ꯊꯨꯒꯥꯏꯔꯒꯥ
থুগাইরে	ꯊꯨꯒꯥꯏꯔꯦ
থুগায়খি	ꯊꯨꯒꯥꯏꯈꯤ
থুগায়খ্রে	ꯊꯨꯒꯥꯏꯈꯔꯦ
থুগায়দুনা	ꯊꯨꯒꯥꯏꯗꯨꯅꯥ
থুগায়বগী	ꯊꯨꯒꯥꯏꯕꯒꯤ
থুগায়বা	ꯊꯨꯒꯥꯏꯕꯥ
থুগায়রবদি	ꯊꯨꯒꯥꯏꯔꯕꯗꯤ
থুদুনা	ꯊꯨꯗꯨꯅꯥ
থুদেক্লে	ꯊꯨꯗꯦꯛꯂꯦ
থুনা	ꯊꯨꯅꯥ
থুবা	ꯊꯨꯕꯥ
থুম	ꯊꯨꯝ
থুমগা	ꯊꯨꯝꯒꯥ
থুমগী	ꯊꯨꯝꯒꯤ
থুমজা	ꯊꯨꯝꯖꯥ
থুমজাগা	ꯊꯨꯝꯖꯥꯒꯥ
থুমজাগী	ꯊꯨꯝꯖꯥꯒꯤ
থুমজাদা	ꯊꯨꯝꯖꯥꯗꯥ
থুমজিনবা	ꯊꯨꯝꯖꯤꯟꯕꯥ
থুমদা	ꯊꯨꯝꯗꯥ
থুমশিং	ꯊꯨꯝꯁꯤꯡ
থুমহি	ꯊꯨꯝꯍꯤ
থেংখাং	ꯊꯦꯡꯈꯥꯡ
থেংথনা	ꯊꯦꯡꯊꯅꯥ
থেংদুনা	ꯊꯦꯪꯗꯨꯅꯥ
থেংনখি	ꯊꯦꯡꯅꯈꯤ
থেংনখিদে	ꯊꯦꯡꯅꯈꯤꯗꯦ
থেংনখিবগা	ꯊꯦꯡꯅꯈꯤꯕꯒꯥ
থেংনখিবগী	ꯊꯦꯡꯅꯈꯤꯕꯒꯤ
থেংনখিবদগী	ꯊꯦꯡꯅꯈꯤꯕꯗꯒꯤ
থেংনখিবনি	ꯊꯦꯡꯅꯈꯤꯕꯅꯤ
থেংনখিবা	ꯊꯦꯡꯅꯈꯤꯕꯥ
থেংনখ্রবা	ꯊꯦꯡꯅꯈ꯭ꯔꯕꯥ
থেংনখ্রে	ꯊꯦꯡꯅꯈ꯭ꯔꯦ
থেংনগদবনি	ꯊꯦꯡꯅꯒꯗꯕꯅꯤ
থেংনগনি	ꯊꯦꯡꯅꯒꯅꯤ
থেংনগে	ꯊꯦꯡꯅꯒꯦ
থেংনদবদগী	ꯊꯦꯡꯅꯗꯕꯗꯒꯤ
থেংনদুনা	ꯊꯦꯡꯅꯗꯨꯅꯥ
থেংনদে	ꯊꯦꯡꯅꯗꯦ
থেংনদ্রি	ꯊꯦꯡꯅꯗ꯭ꯔꯤ
থেংনদ্রে	ꯊꯦꯡꯅꯗ꯭ꯔꯦ
থেংননবগী	ꯊꯦꯡꯅꯅꯕꯒꯤ
থেংননবগীদমক	ꯊꯦꯡꯅꯅꯕꯒꯤꯗꯃꯛ
থেংননবা	ꯊꯦꯡꯅꯅꯕꯥ
থেংননা	ꯊꯦꯡꯅꯅꯥ
থেংনবগা	ꯊꯦꯡꯅꯕꯒꯥ
থেংনবগী	ꯊꯦꯡꯅꯕꯒꯤ
থেংনবদগী	ꯊꯦꯡꯅꯕꯗꯒꯤ
থেংনবদা	ꯊꯦꯡꯅꯕꯗꯥ
থেংনবনি	ꯊꯦꯡꯅꯕꯅꯤ
থেংনবা	ꯊꯦꯡꯅꯕꯥ
থেংনমিন্নগদবনি	ꯊꯦꯡꯅꯃꯤꯟꯅꯒꯗꯕꯅꯤ
থেংনমিন্নবা	ꯊꯦꯡꯅꯃꯤꯟꯅꯕꯥ
থেংনরকখি	ꯊꯦꯡꯅꯔꯛꯈꯤ
থেংনরকখিবনি	ꯊꯦꯡꯅꯔꯛꯈꯤꯕꯅꯤ
থেংনরকখিবা	ꯊꯦꯡꯅꯔꯛꯈꯤꯕꯥ
থেংনরকপদগী	ꯊꯦꯡꯅꯔꯛꯄꯗꯒꯤ
থেংনরকপনি	ꯊꯦꯡꯅꯔꯛꯄꯅꯤ
থেংনরকপশিং	ꯊꯦꯡꯅꯔꯛꯄꯁꯤꯡ
থেংনরকপা	ꯊꯦꯡꯅꯔꯛꯄꯥ
থেংনরক্লি	ꯊꯦꯡꯅꯔꯛꯂꯤ
থেংনরক্লিবা	ꯊꯦꯡꯅꯔꯛꯂꯤꯕꯥ
থেংনরগনি	ꯊꯦꯡꯅꯔꯒꯅꯤ
থেংনরবদি	ꯊꯦꯡꯅꯔꯕꯗꯤ
থেংনরবসু	ꯊꯦꯡꯅꯔꯕꯁꯨ
থেংনরবা	ꯊꯦꯡꯅꯔꯕꯥ
থেংনরম্মী	ꯊꯦꯡꯅꯔꯝꯃꯤ
থেংনরি	ꯊꯦꯡꯅꯔꯤ
থেংনরিবা	ꯊꯦꯡꯅꯔꯤꯕꯥ
থেংনরুবা	ꯊꯦꯪꯅꯔꯨꯕꯥ
থেংনরুরবদি	ꯊꯦꯡꯅꯔꯨꯔꯕꯗꯤ
থেংনরে	ꯊꯦꯡꯅꯔꯦ
থেংনা	ꯊꯦꯡꯅꯥ
থেংনৈ	ꯊꯦꯡꯅꯩ
থেংবগী	ꯊꯦꯡꯕꯒꯤ
থেংবা	ꯊꯦꯡꯕꯥ
থেংলবসু	ꯊꯦꯡꯂꯕꯁꯨ
থেক	ꯊꯦꯀ
থেঙ্ক	ꯊꯦꯡꯀ
থেম্বদা	ꯊꯦꯝꯕꯗꯥ
থেম্বা	ꯊꯦꯝꯕꯥ
থেৎতুনা	ꯊꯦꯠꯇꯨꯅꯥ
থেৎপা	ꯊꯦꯠꯄꯥ
থেৎলি	ꯊꯦꯠꯂꯤ
থৈদুনা	ꯊꯩꯗꯨꯅꯥ
থৈরগা	ꯊꯩꯔꯒꯥ
থ্রি	ꯊ꯭ꯔꯤ
থ্রিগী	ꯊ꯭ꯔꯤꯒꯤ
থ্রিদা	ꯊ꯭ꯔꯤꯗꯥ
থ্রু	ꯊ꯭ꯔꯨ
থৎখি	ꯊꯠꯈꯤ
থৎতুনা	ꯊꯠꯇꯨꯅꯥ
থৎনা	ꯊꯠꯅꯥ
থৱান	ꯊꯋꯥꯅ
থৱানমিচাক	ꯊꯋꯥꯟꯃꯤꯆꯥꯛ
থৱায়	ꯊꯋꯥꯏ
থৱায়না	ꯊꯋꯥꯏꯅꯥ
দ	ꯗ
দং	ꯗꯪ
দগী	ꯗꯒꯤ
দগীদি	ꯗꯒꯤꯗꯤ
দগীনা	ꯗꯒꯤꯅꯥ
দগীনি	ꯗꯒꯤꯅꯤ
দগীসু	ꯗꯒꯤꯁꯨ
দদি	ꯗꯗꯤ
দনা	ꯗꯅꯥ
দনি	ꯗꯅꯤ
দন্দি	ꯗꯟꯗꯤ
দবল	ꯗꯕꯜ
দবা	ꯗꯕꯥ
দমক	ꯗꯃꯛ
দমান	ꯗꯃꯥꯅ
দরকার	ꯗꯔꯀꯥꯔ
দরকারগী	ꯗꯔꯀꯥꯔꯒꯤ
দরখাষ্ট	ꯗꯔꯈꯥꯁ꯭ꯇ
দরবার	ꯗꯔꯕꯥꯔ
দর্শন	ꯗꯔꯁꯟ
দল	ꯗꯜ
দলগী	ꯗꯜꯒꯤ
দলদা	ꯗꯜꯗꯥ
দলনা	ꯗꯜꯅꯥ
দলশিং	ꯗꯜꯁꯤꯡ
দলশিংগী	ꯗꯜꯁꯤꯡꯒꯤ
দলাই	ꯗꯂꯥꯏ
দলান	ꯗꯂꯥꯅ
দলিট	ꯗꯂꯤꯠ
দলিত	ꯗꯂꯤꯠ
দশা	ꯗꯁꯥ
দষ্টবিন	ꯗꯁꯇꯕꯤꯟ
দসু	ꯗꯁꯨ
দসেরা	ꯗꯁꯦꯔꯥ
দসেরাগী	ꯗꯁꯦꯔꯥꯒꯤ
দহিয়া	ꯗꯍꯤꯌꯥ
দা	ꯗꯥ
দাইও	ꯗꯥꯏꯑꯣ
দাইত্ব	ꯗꯥꯏꯇ
দাইনা	ꯗꯥꯏꯅꯥ
দাইনামিক	ꯗꯥꯏꯅꯥꯃꯤꯛ
দাইবেটিসনা	ꯗꯥꯏꯕꯦꯇꯤꯁꯅꯥ
দাইরি	ꯗꯥꯏꯔꯤ
দাইরেক্ট	ꯗꯥꯏꯔꯦꯛꯇ
দাইলাইসিস	ꯗꯥꯏꯂꯥꯏꯁꯤꯁ
দাইলেগ	ꯗꯥꯏꯂꯦꯒ
দাক	ꯗꯥꯛ
দাগ	ꯗꯥꯒ
দাটা	ꯗꯥꯇꯥ
দাদা	ꯗꯥꯗꯥ
দান	ꯗꯥꯟ
দান্স	ꯗꯥꯟꯁ
দাবী	ꯗꯥꯕꯤ
দাম	ꯗꯥꯝ
দামনা	ꯗꯥꯝꯅꯥ
দারুল	ꯗꯥꯔꯨꯜ
দার্জলিং	ꯗꯥꯔꯖꯂꯤꯡ
দার্জিলিংগী	ꯗꯥꯔꯖꯤꯂꯤꯡꯒꯤ
দাস	ꯗꯥꯁ
দাসনা	ꯗꯥꯁꯅꯥ
দায়ত্ব	ꯗꯥꯏꯠꯕ
দাৱুদ	ꯗꯥꯋꯨꯗ
দি	ꯗꯤ
দিক্লারেসন	ꯗꯤꯛꯂꯥꯔꯦꯁꯟ
দিক্সনারি	ꯗꯤꯛꯁꯅꯥꯔꯤ
দিগী	ꯗꯤꯒꯤ
দিগ্রি	ꯗꯤꯒꯔꯤ
দিচার্জ	ꯗꯤꯆꯥꯔꯖ
দিজল	ꯗꯤꯖꯜ
দিজাইন	ꯗꯤꯖꯥꯏꯟ
দিজাষ্টর	ꯗꯤꯖꯥꯁꯇ꯭ꯔ
দিজি	ꯗꯤꯖꯤ
দিজিগনেটেদ	ꯗꯤꯖꯤꯒꯅꯦꯇꯦꯗ
দিজিজ	ꯗꯤꯖꯤꯖ
দিজিট	ꯗꯤꯖꯤꯠ
দিজিটেল	ꯗꯤꯖꯤꯇꯦꯜ
দিজিটেলগী	ꯗꯤꯖꯤꯇꯦꯜꯒꯤ
দিন	ꯗꯤꯅ
দিনেশ	ꯗꯤꯅꯦꯁ
দিনেস	ꯗꯤꯅꯦꯁ
দিপক	ꯗꯤꯄꯛ
দিপার্টমেন্ট	ꯗꯤꯄꯥꯔꯠꯃꯦꯟꯇ
দিপার্টমেন্টকা	ꯗꯤꯄꯥꯔꯠꯃꯦꯟꯇꯀꯥ
দিপার্টমেন্টকী	ꯗꯤꯄꯥꯔꯠꯃꯦꯟꯇꯀꯤ
দিপার্টমেন্টগী	ꯗꯤꯄꯥꯔꯠꯃꯦꯟꯇꯒꯤ
দিপার্টমেন্টতা	ꯗꯤꯄꯥꯔꯠꯃꯦꯟꯇꯇꯥ
দিপার্টমেন্টনসু	ꯗꯤꯄꯥꯔꯠꯃꯦꯟꯇꯅꯁꯨ
দিপার্টমেন্টনা	ꯗꯤꯄꯥꯔꯠꯃꯦꯟꯇꯅꯥ
দিপার্টমেন্টশিং	ꯗꯤꯄꯥꯔꯠꯃꯦꯟꯇꯁꯤꯡ
দিপার্টমেন্টশিংগা	ꯗꯤꯄꯥꯔꯠꯃꯦꯟꯇꯁꯤꯡꯒꯥ
দিপার্টমেন্টশিংগী	ꯗꯤꯄꯥꯔꯠꯃꯦꯟꯇꯁꯤꯡꯒꯤ
দিপার্টমেন্টশিংদা	ꯗꯤꯄꯥꯔꯠꯃꯦꯟꯇꯁꯤꯡꯗꯥ
দিপার্টমেন্টশিংনসু	ꯗꯤꯄꯥꯔꯠꯃꯦꯟꯇꯁꯤꯡꯅꯁꯨ
দিপার্টমেন্টশিংনা	ꯗꯤꯄꯥꯔꯠꯃꯦꯟꯇꯁꯤꯡꯅꯥ
দিপিকা	ꯗꯤꯄꯤꯀꯥ
দিপুটি	ꯗꯤꯄꯨꯇꯤ
দিপুতি	ꯗꯤꯄꯨꯇꯤ
দিপ্রেসন	ꯗꯤꯄ꯭ꯔꯦꯁꯟ
দিফেক্সন	ꯗꯤꯐꯦꯛꯁꯟ
দিফেন্স	ꯗꯤꯐꯦꯟꯁ
দিফেন্সকী	ꯗꯤꯐꯦꯟꯁꯀꯤ
দিফেন্সনা	ꯗꯤꯐꯦꯟꯁꯅꯥ
দিবলপ	ꯗꯤꯕꯂꯄ
দিবলপমেন্ট	ꯗꯤꯕꯂꯞꯃꯦꯟꯇ
দিবলপমেন্টকী	ꯗꯤꯕꯂꯞꯃꯦꯟꯇꯀꯤ
দিবলপমেন্টতা	ꯗꯤꯕꯂꯞꯃꯦꯟꯇꯇꯥ
দিবলপমেন্টনা	ꯗꯤꯕꯂꯞꯃꯦꯟꯇꯅꯥ
দিবস	ꯗꯤꯕꯁ
দিবিজননা	ꯗꯤꯕꯤꯖꯟꯅꯥ
দিবেট	ꯗꯤꯕꯦꯠ
দিবেটতা	ꯗꯤꯕꯦꯠꯇꯥ
দিভলপমেন্ট	ꯗꯤꯚꯂꯞꯃꯦꯟꯇ
দিভাইদ	ꯗꯤꯚꯥꯏꯗ
দিভাইসশিং	ꯗꯤꯚꯥꯏꯁꯁꯤꯡ
দিভিজন	ꯗꯤꯚꯤꯖꯟ
দিভিজনগী	ꯗꯤꯚꯤꯖꯟꯒꯤ
দিভিজনদা	ꯗꯤꯚꯤꯖꯟꯗꯥ
দিভিজনেল	ꯗꯤꯚꯤꯖꯅꯦꯜ
দিভিজন্দা	ꯗꯤꯚꯤꯖꯟꯗꯥ
দিভেলপমেন্ট	ꯗꯤꯚꯦꯂꯞꯃꯦꯟꯇ
দিমান্দ	ꯗꯤꯃꯥꯟꯗ
দিমান্দদা	ꯗꯤꯃꯥꯟꯗꯗꯥ
দিমান্দশিং	ꯗꯤꯃꯥꯟꯗꯁꯤꯡ
দিমাপুর	ꯗꯤꯃꯥꯄꯨꯔ
দিমাপুরদা	ꯗꯤꯃꯥꯄꯨꯔꯗꯥ
দিমার্কেসন	ꯗꯤꯃꯥ꯭ꯔꯀꯦꯁꯟ
দিরেক্টর	ꯗꯤꯔꯦꯛꯇꯔ
দিরেক্সন	ꯗꯤꯔꯦꯛꯁꯟ
দিরেক্সনগী	ꯗꯤꯔꯦꯛꯁꯟꯒꯤ
দিল	ꯗꯤꯜ
দিলি	ꯗꯤꯂꯤ
দিলিপ	ꯗꯤꯂꯤꯞ
দিল্লি	ꯗꯤꯜꯂꯤ
দিল্লিগা	ꯗꯤꯜꯂꯤꯒꯥ
দিল্লিগী	ꯗꯤꯜꯂꯤꯒꯤ
দিল্লিদগী	ꯗꯤꯜꯂꯤꯗꯒꯤ
দিল্লিদদি	ꯗꯤꯜꯂꯤꯗꯗꯤ
দিল্লিদা	ꯗꯤꯜꯂꯤꯗꯥ
দিল্লিনা	ꯗꯤꯜꯂꯤꯅꯥ
দিল্লী	ꯗꯤꯜꯂꯤ
দিল্লীগী	ꯗꯤꯜꯂꯤꯒꯤ
দিল্লীদা	ꯗꯤꯜꯂꯤꯗꯥ
দিষ্টর্ব	ꯗꯤꯁꯇ꯭ꯔꯕ
দিষ্টেন্স	ꯗꯤꯁꯇꯦꯟꯁ
দিষ্টেন্সিং	ꯗꯤꯁꯇꯦꯟꯁꯤꯡ
দিষ্টেন্সিংগী	ꯗꯤꯁꯇꯦꯟꯁꯤꯡꯒꯤ
দিষ্ট্রক্ট	ꯗꯤꯁꯇ꯭ꯔꯛꯇ
দিষ্ট্রিক্ট	ꯗꯤꯁꯇ꯭ꯔꯤꯛꯇ
দিষ্ট্রিক্টকী	ꯗꯤꯁꯇ꯭ꯔꯤꯛꯇꯀꯤ
দিষ্ট্রিক্টতগী	ꯗꯤꯁꯇ꯭ꯔꯤꯛꯇꯇꯒꯤ
দিষ্ট্রিক্টতগীনি	ꯗꯤꯁꯇ꯭ꯔꯤꯛꯇꯇꯒꯤꯅꯤ
দিষ্ট্রিক্টতা	ꯗꯤꯁꯇ꯭ꯔꯤꯛꯇꯇꯥ
দিষ্ট্রিক্টনা	ꯗꯤꯁꯇ꯭ꯔꯤꯛꯇꯅꯥ
দিষ্ট্রিক্টশিংগী	ꯗꯤꯁꯇ꯭ꯔꯤꯛꯇꯁꯤꯡꯒꯤ
দিষ্ট্রিক্টশিংদা	ꯗꯤꯁꯇ꯭ꯔꯤꯛꯇꯁꯤꯡꯗꯥ
দিষ্ট্রিক্টশিংনা	ꯗꯤꯁꯇ꯭ꯔꯤꯛꯇꯁꯤꯡꯅꯥ
দিস	ꯗꯤꯁ
দিসএবল	ꯗꯤꯁꯑꯦꯕꯜ
দিসওবিদেন্স	ꯗꯤꯁꯑꯣꯕꯤꯗꯦꯟꯁ
দিসক্বালিফাই	ꯗꯤꯁꯀ꯭ꯋꯥꯂꯤꯐꯥꯏ
দিসক্বালিফিকেসন	ꯗꯤꯁꯀ꯭ꯋꯥꯂꯤꯐꯤꯀꯦꯁꯟ
দিসচার্জ	ꯗꯤꯁꯆꯥꯔꯖ
দিসটেন্সিংগী	ꯗꯤꯁꯇꯦꯟꯁꯤꯡꯒꯤ
দিসপেন্সরি	ꯗꯤꯁꯄꯦꯟꯁꯔꯤ
দিসপ্লে	ꯗꯤꯁꯄꯂꯦ
দিসি	ꯗꯤꯁꯤ
দিসিজন	ꯗꯤꯁꯤꯖꯟ
দিসিপ্লিন	ꯗꯤꯁꯤꯄꯂꯤꯅ
দিসেম্বর	ꯗꯤꯁꯦꯝꯕꯔ
দিসেম্বরদগী	ꯗꯤꯁꯦꯝꯕꯔꯗꯒꯤ
দিসেম্বরদা	ꯗꯤꯁꯦꯝꯕꯔꯗꯥ
দিস্কসন	ꯗꯤꯁꯀꯁꯟ
দিৱালি	ꯗꯤꯋꯥꯂꯤ
দিৱালিদা	ꯗꯤꯋꯥꯂꯤꯗꯥ
দুকান	ꯗꯨꯀꯥꯟ
দুকানশিং	ꯗꯨꯀꯥꯟꯁꯤꯟ
দুকানশিংগী	ꯗꯨꯀꯥꯟꯁꯤꯡꯒꯤ
দুকানশিংদা	ꯗꯨꯀꯥꯟꯁꯤꯡꯗꯥ
দুকানশিংদি	ꯗꯨꯀꯥꯟꯁꯤꯡꯗꯤ
দুকানশিংনা	ꯗꯨꯀꯥꯟꯁꯤꯡꯅꯥ
দুকানশিংসু	ꯗꯨꯀꯥꯟꯁꯤꯡꯁꯨ
দুকান্দারশিংনা	ꯗꯨꯀꯥꯟꯗꯥꯔꯁꯤꯪꯅꯥ
দুকান্নচিংবা	ꯗꯨꯀꯥꯟꯅꯆꯤꯡꯕꯥ
দুগী	ꯗꯨꯒꯤ
দুনা	ꯗꯨꯅꯥ
দুবাই	ꯗꯨꯕꯥꯏ
দুবাইদা	ꯗꯨꯕꯥꯏꯗꯥ
দুরদর্শন	ꯗꯨꯔꯗꯔꯁꯟ
দুরর্দশন	ꯗꯨꯔꯗꯁꯟ
দুর্গা	ꯗꯨꯔꯒꯥ
দে	ꯗꯦ
দেগা	ꯗꯦꯒꯥ
দেগী	ꯗꯦꯒꯤ
দেট	ꯗꯦꯇ
দেটা	ꯗꯦꯇꯥ
দেথ	ꯗꯦꯊ
দেদা	ꯗꯦꯗꯥ
দেদিকেটেদ	ꯗꯦꯗꯤꯀꯦꯇꯦꯗ
দেনমার্ক	ꯗꯦꯟꯃꯥꯔꯀ
দেনা	ꯗꯦꯅꯥ
দেনি	ꯗꯦꯅꯤ
দেব	ꯗꯦꯕ
দেবগী	ꯗꯦꯕꯒꯤ
দেবদাস	ꯗꯦꯕꯗꯥꯁ
দেবনা	ꯗꯦꯕꯅꯥ
দেবা	ꯗꯦꯕꯥ
দেবাননা	ꯗꯦꯕꯥꯟꯅꯥ
দেবিদ	ꯗꯦꯕꯤꯗ
দেবী	ꯗꯦꯕꯤ
দেবীগা	ꯗꯦꯕꯤꯒꯥ
দেবীগী	ꯗꯦꯕꯤꯒꯤ
দেবীনা	ꯗꯦꯕꯤꯅꯥ
দেবীনি	ꯗꯦꯕꯤꯅꯤ
দেবীবু	ꯗꯦꯕꯤꯕꯨ
দেবীসু	ꯗꯦꯕꯤꯁꯨ
দেবেন	ꯗꯦꯕꯦꯟ
দেবেননা	ꯗꯦꯕꯦꯟꯅꯥ
দেবেন্দ্র	ꯗꯦꯕꯦꯟꯗꯔ꯭
দেরাদুনদা	ꯗꯦꯔꯥꯗꯨꯟꯗꯥ
দেলটা	ꯗꯦꯜꯇꯥ
দেলিভরি	ꯗꯦꯂꯤꯚꯔꯤ
দেশ	ꯗꯦꯁ
দেস	ꯗꯦꯁ
দেসমুখনা	ꯗꯦꯁꯃꯨꯈꯅꯥ
দেসাম	ꯗꯦꯁꯥꯝ
দেসামগী	ꯗꯦꯁꯥꯝꯒꯤ
দেসামনা	ꯗꯦꯁꯥꯝꯅꯥ
দেৱান	ꯗꯦꯋꯥꯟ
দ্রগ	ꯗꯔ꯭ꯒ
দ্রগকা	ꯗꯔ꯭ꯒꯀꯥ
দ্রগকী	ꯗꯔ꯭ꯒꯀꯤ
দ্রগনা	ꯗꯔ꯭ꯒꯅꯥ
দ্রগশিং	ꯗꯔ꯭ꯒꯁꯤꯡ
দ্রগস	ꯗꯔ꯭ꯒꯁ
দ্রমা	ꯗ꯭ꯔꯃꯥ
দ্রাই	ꯗ꯭ꯔꯥꯏ
দ্রাইব	ꯗ꯭ꯔꯥꯏꯕ
দ্রাইবতা	ꯗ꯭ꯔꯥꯏꯕꯇꯥ
দ্রাইবর	ꯗ꯭ꯔꯥꯏꯕꯔ
দ্রাইবরশিং	ꯗ꯭ꯔꯥꯏꯕꯔꯁꯤꯡ
দ্রাইভ	ꯗꯔꯥꯏꯚ
দ্রাইভর	ꯗꯔꯥꯏꯚꯔ
দ্রাইভরগী	ꯗꯔꯥꯏꯚꯔꯒꯤ
দ্রাইভরশিং	ꯗꯔꯥꯏꯚꯔꯁꯤꯡ
দ্রাইভরশিংগী	ꯗꯔꯥꯏꯚꯔꯁꯤꯡꯒꯤ
দ্রাইভরশিংদা	ꯗꯔꯥꯏꯚꯔꯁꯤꯡꯗꯥ
দ্রাইভিং	ꯗꯔꯥꯏꯚꯤꯡ
দ্রাফট	ꯗ꯭ꯔꯥꯐꯇ
দ্রাফটিং	ꯗ꯭ꯔꯥꯐꯇꯤꯡ
দ্রামা	ꯗꯔꯥꯃꯥ
দ্রামাগী	ꯗꯔꯥꯃꯥꯒꯤ
দ্রামাটিক	ꯗꯔꯥꯃꯥꯇꯤꯛ
দ্রামাশিং	ꯗꯔꯥꯃꯥꯁꯤꯡ
দ্রিঙ্কিং	ꯗꯔꯤꯡꯀꯤꯡ
দ্রিপ	ꯗꯔꯤꯞ
দ্রেস	ꯗ꯭ꯔꯦꯁ
দয়া	ꯗꯌꯥ
দয়ানন্দা	ꯗꯌꯥꯟꯅꯗꯥ
দয়াল	ꯗꯌꯥꯜ
ধনচন্দ্র	ꯙꯟꯆꯟꯗꯔ꯭
ধনমঞ্জুরি	ꯙꯅꯃꯟꯖꯨꯔꯤ
ধরমেন্দ্র	ꯙꯔꯃꯦꯟꯗꯔ
ধাকা	ꯙꯥꯀꯥ
ধাকাদা	ꯙꯥꯀꯥꯗꯥ
ধারা	ꯙꯥꯔꯥ
ধুপ	ꯙꯨꯄ
ন	ꯅ
নংখি	ꯅꯪꯈꯤ
নংখিবনি	ꯅꯪꯈꯤꯕꯅꯤ
নংখিবা	ꯅꯪꯈꯤꯕꯥ
নংখ্রবা	ꯅꯪꯈ꯭ꯔꯕꯥ
নংখ্রে	ꯅꯪꯈ꯭ꯔꯦ
নংদুনা	ꯅꯪꯗꯨꯅꯥ
নংনবা	ꯅꯪꯅꯕꯥ
নংবা	ꯅꯪꯕꯥ
নংলবশিংদা	ꯅꯪꯂꯕꯁꯤꯡꯗꯥ
নংলবা	ꯅꯪꯂꯕꯥ
নংলিবা	ꯅꯪꯂꯤꯕꯥ
নকপদা	ꯅꯛꯄꯗꯥ
নকপা	ꯅꯛꯄꯥ
নকশিন্ননা	ꯅꯛꯁꯤꯟꯅꯅꯥ
নকশিন্নবা	ꯅꯛꯁꯤꯟꯅꯕꯥ
নকশিল্লকপগা	ꯅꯛꯁꯤꯜꯂꯛꯄꯒꯥ
নকশিল্লকপা	ꯅꯛꯁꯤꯜꯂꯛꯄꯥ
নকশিল্লক্লে	ꯅꯛꯁꯤꯜꯂꯛꯂꯦ
নক্ননা	ꯅꯛꯅꯅꯥ
নক্নবা	ꯅꯛꯅꯕꯥ
নক্নরম্বা	ꯅꯛꯅꯔꯝꯕꯥ
নক্না	ꯅꯛꯅꯥ
নগর	ꯅꯒꯔ
নগরদা	ꯅꯒꯔꯗꯥ
নঙ	ꯅꯡ
নঙনা	ꯅꯡꯅꯥ
নঙবু	ꯅꯡꯕꯨ
নচা	ꯅꯆꯥ
নচাদা	ꯅꯆꯥꯗꯥ
নচাদি	ꯅꯆꯥꯗꯤ
নচাবু	ꯅꯆꯥꯕꯨ
নচিংবা	ꯅꯆꯤꯡꯕꯥ
নজমা	ꯅꯖꯃꯥ
নট	ꯅꯠ
নত্তনা	ꯅꯠꯇꯅꯥ
নত্তবদা	ꯅꯠꯇꯕꯗꯥ
নত্তবনিনা	ꯅꯠꯇꯕꯅꯤꯅꯥ
নত্তবা	ꯅꯠꯇꯕꯥ
নত্তরা	ꯅꯠꯇꯔꯥ
নত্তে	ꯅꯠꯇꯦ
নত্ত্রগা	ꯅꯠꯇꯔ꯭ꯒꯥ
নত্ত্রবদি	ꯅꯠꯇꯔ꯭ꯕꯗꯤ
নত্ত্রে	ꯅꯠꯇꯔꯦ
নথন্তা	ꯅꯊꯟꯇꯥ
নদি	ꯅꯗꯤ
নদ্দনা	ꯅꯗꯗꯅꯥ
নদ্দাগসু	ꯅꯗꯗꯥꯒꯁꯨ
নদ্দানা	ꯅꯗꯗꯥꯅꯥ
নন	ꯅꯟ
ননা	ꯅꯅꯥ
ননাই	ꯅꯅꯥꯏ
ননাইগী	ꯅꯅꯥꯏꯒꯤ
ননাইনা	ꯅꯅꯥꯏꯅꯥ
ননাও	ꯅꯅꯥꯑꯣ
ননীং	ꯅꯅꯤꯪ
নন্দ	ꯅꯟꯗ
নন্দকুমার	ꯅꯟꯗꯀꯨꯃꯥꯔ
নন্দকুমারনা	ꯅꯟꯗꯀꯨꯃꯥꯔꯅꯥ
নন্দন	ꯅꯟꯗꯟ
নপ	ꯅꯞ
নপা	ꯅꯄꯥ
নফসা	ꯅꯐꯁꯥ
নবকিশ্বর	ꯅꯕꯀꯤꯁꯋ꯭ꯔ
নবকুমার	ꯅꯕꯀꯨꯃꯥꯔ
নবচন্দ্র	ꯅꯕꯆꯟꯗꯔ꯭
নবচন্দ্রনা	ꯅꯕꯆꯟꯗꯔ꯭ꯅꯥ
নবা	ꯅꯕꯥ
নবিন	ꯅꯕꯤꯟ
নবুক	ꯅꯕꯨꯀ
নবেম্বর	ꯅꯕꯦꯝꯕꯔ
নবেম্বরগী	ꯅꯕꯦꯝꯕꯔꯒꯤ
নবেম্বরদা	ꯅꯕꯦꯝꯕꯔꯗꯥ
নভেম্বর	ꯅꯚꯦꯝꯕꯔ
নম	ꯅꯝ
নমথদুনা	ꯅꯝꯊꯗꯨꯅꯥ
নমথবা	ꯅꯝꯊꯕꯥ
নমথবিরবা	ꯅꯝꯊꯕꯤꯔꯕꯥ
নমথাক	ꯅꯝꯊꯥꯛ
নমদুনা	ꯅꯝꯗꯨꯅꯥ
নমাঙ	ꯅꯃꯥꯉ
নমাদা	ꯅꯃꯥꯗꯥ
নমু	ꯅꯃꯨ
নম্না	ꯅꯝꯅꯥ
নম্ফুদা	ꯅꯝꯐꯨꯗꯥ
নম্বগা	ꯅꯝꯕꯒꯥ
নম্বদা	ꯅꯝꯕꯗꯥ
নম্বর	ꯅꯝꯕꯔ
নম্বরনা	ꯅꯝꯕꯔꯅꯥ
নম্বা	ꯅꯝꯕꯥ
নম্বুল	ꯅꯝꯕꯨꯜ
নম্লগা	ꯅꯝꯂꯒꯥ
নরনা	ꯅꯔꯅꯥ
নরসিংহ	ꯅꯔꯁꯤꯡꯍ
নরা	ꯅꯔꯥ
নরায়ন	ꯅꯔꯥꯏꯅ
নরেন্দ্র	ꯅꯔꯦꯟꯗ꯭ꯔ
নরেসনা	ꯅꯔꯦꯁꯅꯥ
নর্স	ꯅꯔꯁ
নর্সশিং	ꯅꯔꯁꯁꯤꯡ
নর্সশিংগী	ꯅꯔꯁꯁꯤꯡꯒꯤ
নর্সিং	ꯅꯔꯁꯤꯡ
নশা	ꯅꯁꯥ
নশানা	ꯅꯁꯥꯅꯥ
নসু	ꯅꯁꯨ
নহা	ꯅꯍꯥ
নহাক	ꯅꯍꯥꯀ
নহাক্কী	ꯅꯍꯥꯛꯀꯤ
নহাক্না	ꯅꯍꯥꯛꯅꯥ
নহান	ꯅꯍꯥꯟ
নহান্তা	ꯅꯍꯥꯟꯇꯥ
নহাশিং	ꯅꯍꯥꯁꯤꯡ
নহাশিংগা	ꯅꯍꯥꯁꯤꯡꯒꯥ
নহাশিংগী	ꯅꯍꯥꯁꯤꯡꯒꯤ
নহাশিংদা	ꯅꯍꯥꯁꯤꯡꯗꯥ
নহাশিংনা	ꯅꯍꯥꯁꯤꯡꯅꯥ
নহাশিংবু	ꯅꯍꯥꯁꯤꯡꯕꯨ
না	ꯅꯥ
নাই	ꯅꯥꯏ
নাইজেরিয়া	ꯅꯥꯏꯖꯦꯔꯤꯌꯥ
নাইট	ꯅꯥꯏꯠ
নাইদনা	ꯅꯥꯏꯗꯅꯥ
নাইদবা	ꯅꯥꯏꯗꯕꯥ
নাইদু	ꯅꯥꯏꯗꯨ
নাইদুনসু	ꯅꯥꯏꯗꯨꯅꯁꯨ
নাইদুনা	ꯅꯥꯏꯗꯨꯅꯥ
নাইদে	ꯅꯥꯏꯗꯦ
নাইদ্রবা	ꯅꯥꯏꯗ꯭ꯔꯕꯥ
নাইন	ꯅꯥꯏꯟ
নাইনগী	ꯅꯥꯏꯟꯒꯤ
নাইনদগী	ꯅꯥꯏꯟꯗꯒꯤ
নাইনা	ꯅꯥꯏꯅꯥ
নাইবগী	ꯅꯥꯏꯕꯒꯤ
নাইবা	ꯅꯥꯏꯕꯥ
নাইরবা	ꯅꯥꯏꯔꯕꯥ
নাওরিয়া	ꯅꯥꯎꯔꯤꯌꯥ
নাওরেম	ꯅꯥꯎꯔꯦꯝ
নাওরেমনা	ꯅꯥꯎꯔꯦꯝꯅꯥ
নাক	ꯅꯥꯛ
নাকনদা	ꯅꯥꯀꯟꯗꯥ
নাকন্দা	ꯅꯥꯀꯟꯗꯥ
নাকপাক	ꯅꯥꯛꯄꯥꯛ
নাকল	ꯅꯥꯀꯜ
নাকলদা	ꯅꯥꯀꯜꯗꯥ
নাখি	ꯅꯥꯈꯤ
নাখিবা	ꯅꯥꯈꯤꯕꯥ
নাগ	ꯅꯥꯒ
নাগপুর	ꯅꯥꯒꯄꯨꯔ
নাগপুরদা	ꯅꯥꯒꯄꯨꯔꯗꯥ
নাগরদা	ꯅꯥꯒꯔꯗꯥ
নাগা	ꯅꯥꯒꯥ
নাগাগী	ꯅꯥꯒꯥꯒꯤ
নাগানা	ꯅꯥꯒꯥꯅꯥ
নাগামপাল	ꯅꯥꯒꯥꯃꯄꯥꯜ
নাগালেন্দ	ꯅꯥꯒꯥꯂꯦꯟꯗ
নাগালেন্দগা	ꯅꯥꯒꯥꯂꯦꯟꯗꯒꯥ
নাগালেন্দগী	ꯅꯥꯒꯥꯂꯦꯟꯗꯒꯤ
নাগালেন্দদগী	ꯅꯥꯒꯥꯂꯦꯟꯗꯗꯒꯤ
নাগালেন্দদা	ꯅꯥꯒꯥꯂꯦꯟꯗꯗꯥ
নাগালেন্দনা	ꯅꯥꯒꯥꯂꯦꯟꯗꯅꯥ
নাগালেন্দা	ꯅꯥꯒꯥꯂꯦꯟꯗꯥ
নাগাশিংনা	ꯅꯥꯒꯥꯁꯤꯡꯅꯥ
নাচুংদবা	ꯅꯥꯆꯨꯪꯗꯕꯥ
নাটক	ꯅꯥꯇꯛ
নাতৈ	ꯅꯥꯇꯩ
নাথৈদুনা	ꯅꯥꯊꯩꯗꯨꯅꯥ
নাদ	ꯅꯥꯗ
নাদনবা	ꯅꯥꯗꯟꯕꯥ
নাদা	ꯅꯥꯗꯥ
নাদু	ꯅꯥꯗꯨ
নাদুগী	ꯅꯥꯗꯨꯒꯤ
নাদুদগী	ꯅꯥꯗꯨꯗꯒꯤ
নাদুদা	ꯅꯥꯗꯨꯗꯥ
নাদুনা	ꯅꯥꯗꯨꯅꯥ
নাদে	ꯅꯥꯗꯦ
নাদ্রিঙৈদা	ꯅꯥꯗ꯭ꯔꯤꯉꯩꯗꯥ
নানক	ꯅꯥꯅꯛ
নানবগী	ꯅꯥꯅꯕꯒꯤ
নানবদা	ꯅꯥꯅꯕꯗꯥ
নানবা	ꯅꯥꯅꯕꯥ
নানা	ꯅꯥꯅꯥ
নান্না	ꯅꯥꯟꯅꯥ
নাপ	ꯅꯥꯄ
নাপল	ꯅꯥꯄꯜ
নাপী	ꯅꯥꯄꯤ
নাপেৎ	ꯅꯥꯄꯦꯠ
নাব	ꯅꯥꯕ
নাবকী	ꯅꯥꯕꯀꯤ
নাবগী	ꯅꯥꯕꯒꯤ
নাবদগী	ꯅꯥꯕꯗꯒꯤ
নাবশিং	ꯅꯥꯕꯁꯤꯡ
নাবা	ꯅꯥꯕꯥ
নাম	ꯅꯥꯝ
নামা	ꯅꯥꯃꯥ
নামৈরাকপম	ꯅꯥꯃꯩꯔꯥꯛꯄꯝ
নামৈরাকপা	ꯅꯥꯃꯩꯔꯥꯛꯄꯥ
নাম্মা	ꯅꯥꯝꯃꯥ
নারক	ꯅꯥꯔꯛ
নারকপদগী	ꯅꯥꯔꯛꯄꯗꯒꯤ
নারকপনি	ꯅꯥꯔꯛꯄꯅꯤ
নারকপা	ꯅꯥꯔꯛꯄꯥ
নারক্কনি	ꯅꯥꯔꯛꯀꯅꯤ
নারক্লিবা	ꯅꯥꯔꯛꯂꯤꯕꯥ
নারগা	ꯅꯥꯔꯒꯥ
নারবদি	ꯅꯥꯔꯕꯗꯤ
নারবশিং	ꯅꯥꯔꯕꯁꯤꯡ
নারবসু	ꯅꯥꯔꯕꯁꯨ
নারবা	ꯅꯥꯔꯕꯥ
নারম্বদগী	ꯅꯥꯔꯝꯕꯗꯒꯤ
নারম্বা	ꯅꯥꯔꯝꯕꯥ
নারি	ꯅꯥꯔꯤ
নারিবনি	ꯅꯥꯔꯤꯕꯅꯤ
নারুবদগী	ꯅꯥꯔꯨꯕꯗꯒꯤ
নারুম	ꯅꯥꯔꯨꯃ
নারে	ꯅꯥꯔꯦ
নারেং	ꯅꯥꯔꯦꯪ
নাল্লি	ꯅꯥꯜꯂꯤ
নাহনবা	ꯅꯥꯍꯟꯕꯥ
নাহন্দনা	ꯅꯥꯍꯟꯗꯅꯥ
নাহুম	ꯅꯥꯍꯨꯝ
নাহেবা	ꯅꯥꯍꯦꯕꯥ
নাৎ	ꯅꯥꯠ
নাৎকা	ꯅꯥꯠꯀꯥ
নাৎকী	ꯅꯥꯠꯀꯤ
নাৎপু	ꯅꯥꯠꯄꯨ
নায়ক	ꯅꯥꯏꯛ
নায়ক্কী	ꯅꯥꯏꯛꯀꯤ
নায়দবা	ꯅꯥꯏꯗꯕꯥ
নায়না	ꯅꯥꯏꯅꯥ
নি	ꯅꯤ
নিংখা	ꯅꯤꯡꯈꯥ
নিংখায়বগী	ꯅꯤꯡꯈꯥꯏꯕꯒꯤ
নিংখায়বদগী	ꯅꯤꯡꯈꯥꯏꯕꯗꯒꯤ
নিংখায়বা	ꯅꯤꯡꯈꯥꯏꯕꯥ
নিংখায়রকপদা	ꯅꯤꯡꯈꯥꯏꯔꯛꯄꯗꯥ
নিংঙাই	ꯅꯤꯪꯉꯥꯏ
নিংতম	ꯅꯤꯡꯇꯝ
নিংতম্না	ꯅꯤꯡꯇꯝꯅꯥ
নিংতম্বদা	ꯅꯤꯡꯇꯝꯕꯗꯥ
নিংতম্বা	ꯅꯤꯡꯇꯝꯕꯥ
নিংতম্লকপদগী	ꯅꯤꯡꯇꯝꯂꯛꯄꯗꯒꯤ
নিংথম	ꯅꯤꯡꯊꯝ
নিংথমথাগী	ꯅꯤꯡꯊꯝꯊꯥꯒꯤ
নিংথি	ꯅꯤꯪꯊꯤ
নিংথিজনা	ꯅꯤꯡꯊꯤꯖꯅꯥ
নিংথিনা	ꯅꯤꯡꯊꯤꯅꯥ
নিংথীনা	ꯅꯤꯡꯊꯤꯅꯥ
নিংথেম	ꯅꯤꯡꯊꯦꯝ
নিংনবা	ꯅꯤꯡꯅꯕꯥ
নিংবগী	ꯅꯤꯡꯕꯒꯤ
নিংবা	ꯅꯤꯡꯕꯥ
নিংলকপা	ꯅꯤꯡꯂꯛꯄꯥ
নিংশিং	ꯅꯤꯡꯁꯤꯡ
নিংশিংখি	ꯅꯤꯡꯁꯤꯡꯈꯤ
নিংশিংগদবনি	ꯅꯤꯡꯁꯤꯡꯒꯗꯕꯅꯤ
নিংশিংদুনা	ꯅꯤꯡꯁꯤꯡꯗꯨꯅꯥ
নিংশিংবগী	ꯅꯤꯡꯁꯤꯡꯕꯒꯤ
নিংশিংবা	ꯅꯤꯡꯁꯤꯡꯕꯥ
নিংশিংলগা	ꯅꯤꯡꯁꯤꯡꯂꯒꯥ
নিংশিংলদুনা	ꯅꯤꯡꯁꯤꯡꯂꯗꯨꯅꯥ
নিংশিংলি	ꯅꯤꯡꯁꯤꯡꯂꯤ
নিংশিংহল্লি	ꯅꯤꯡꯁꯤꯡꯍꯜꯂꯤ
নিংশিংহল্লে	ꯅꯤꯡꯁꯤꯡꯍꯜꯂꯦ
নিকিতা	ꯅꯤꯀꯤꯇꯥ
নিগী	ꯅꯤꯒꯤ
নিতিন	ꯅꯤꯇꯤꯟ
নিতিস	ꯅꯤꯇꯤꯁ
নিতেস	ꯅꯤꯇꯦꯁ
নিদা	ꯅꯤꯗꯥ
নিদি	ꯅꯤꯗꯤ
নিধি	ꯅꯤꯙꯤ
নিধিগী	ꯅꯤꯙꯤꯒꯤ
নিনি	ꯅꯤꯅꯤ
নিনিগী	ꯅꯤꯅꯤꯒꯤ
নিনিদা	ꯅꯤꯅꯤꯗꯥ
নিন্দা	ꯅꯤꯟꯗꯥ
নিপা	ꯅꯤꯄꯥ
নিপান	ꯅꯤꯄꯥꯟ
নিপানদগী	ꯅꯤꯄꯥꯅꯗꯒꯤ
নিপানদা	ꯅꯤꯄꯥꯟꯗꯥ
নিপান্দগী	ꯅꯤꯄꯥꯟꯗꯒꯤ
নিপান্না	ꯅꯤꯄꯥꯟꯅꯥ
নিপাল	ꯅꯤꯄꯥꯂ
নিপালগী	ꯅꯤꯄꯥꯂꯒꯤ
নিপালদগী	ꯅꯤꯄꯥꯂꯗꯒꯤ
নিপালদা	ꯅꯤꯄꯥꯂꯗꯥ
নিবেদিতা	ꯅꯤꯕꯦꯗꯤꯇꯥ
নিম	ꯅꯤꯝ
নিমাই	ꯅꯤꯃꯥꯏ
নিমাইচরন	ꯅꯤ꯱ꯃꯥꯏꯆ꯭ꯔꯟ
নিমাইচান্দ	ꯅꯤꯃꯥꯏꯆꯥꯟꯗ
নিরভয়া	ꯅꯤꯔꯚꯌꯥ
নিরমলা	ꯅꯤꯔꯃꯂꯥ
নিল	ꯅꯤꯂꯥ
নিলকান্তা	ꯅꯤꯂꯀꯥꯟꯇꯥ
নিলমনিগী	ꯅꯤꯂꯝꯅꯤꯒꯤ
নিলাম	ꯅꯤꯂꯥꯃꯥ
নিশা	ꯅꯤꯁꯥ
নিশাগী	ꯅꯤꯁꯥꯒꯤ
নিশানা	ꯅꯤꯁꯥꯅꯥ
নিশাশিং	ꯅꯤꯁꯥꯁꯤꯡ
নিশিকান্ত	ꯅꯤꯁꯤꯀꯥꯟꯇ
নিয়ম	ꯅꯤꯌꯝ
নিয়াজ	ꯅꯤꯌꯥꯖꯥ
নী	ꯅꯤ
নীং	ꯅꯤꯡ
নীংখা	ꯅꯤꯡꯈꯥ
নীংজদুনা	ꯅꯤꯪꯖꯗꯨꯅꯥ
নীংতম	ꯅꯤꯡꯇꯝ
নীংতম্না	ꯅꯤꯡꯇꯝꯅꯥ
নীংতম্বগী	ꯅꯤꯡꯇꯝꯕꯒꯤ
নীংতম্বা	ꯅꯤꯡꯇꯝꯕꯥ
নীংথি	ꯅꯤꯪꯊꯤ
নীংথিজনা	ꯅꯤꯡꯊꯤꯖꯅꯥ
নীংথিজরবা	ꯅꯤꯡꯊꯤꯖꯔꯕꯥ
নীংথিনা	ꯅꯤꯡꯊꯤꯅꯥ
নীংথিবা	ꯅꯤꯪꯊꯤꯕꯥ
নীংদ্রে	ꯅꯤꯪꯗꯔꯦ
নীংবগী	ꯅꯤꯡꯕꯒꯤ
নীংবা	ꯅꯤꯡꯕꯥ
নীংবু	ꯅꯤꯪꯕꯨ
নীংশিং	ꯅꯤꯡꯁꯤꯡ
নীংশিংখি	ꯅꯤꯡꯁꯤꯡꯈꯤ
নীংশিংদুনা	ꯅꯤꯡꯁꯤꯡꯗꯨꯅꯥ
নীংশিংদ্রে	ꯅꯤꯪꯁꯤꯪꯗꯔꯦ
নীংশিংনরি	ꯅꯤꯡꯁꯤꯡꯅꯔꯤ
নীংশিংফম	ꯅꯤꯡꯁꯤꯡꯐꯝ
নীংশিংবগা	ꯅꯤꯡꯁꯤꯡꯕꯒꯥ
নীংশিংবগী	ꯅꯤꯡꯁꯤꯡꯕꯒꯤ
নীংশিংবা	ꯅꯤꯡꯁꯤꯡꯕꯥ
নীংশিংলকই	ꯅꯤꯡꯁꯤꯡꯂꯛꯏ
নীংশিংলদুনা	ꯅꯤꯡꯁꯤꯡꯂꯗꯨꯅꯥ
নীংশিংলি	ꯅꯤꯡꯁꯤꯡꯂꯤ
নীংশিংলুরগা	ꯅꯤꯪꯁꯤꯪꯂꯨꯔꯒꯥ
নীংশিংহনবা	ꯅꯤꯡꯁꯤꯡꯍꯟꯕꯥ
নীংশিংহল্লি	ꯅꯤꯡꯁꯤꯪꯡꯍꯜꯂꯤ
নীংহন্নবা	ꯅꯤꯪꯍꯟꯅꯕꯥ
নীক্না	ꯅꯤꯛꯅꯥ
নীখি	ꯅꯤꯈꯤ
নীতি	ꯅꯤꯇꯤ
নীনি	ꯅꯤꯅꯤ
নু	ꯅꯨ
নুং	ꯅꯨꯪ
নুংগী	ꯅꯨꯡꯒꯤ
নুংঙাই	ꯅꯨꯡꯉꯥꯏ
নুংঙাইখি	ꯅꯨꯪꯉꯥꯏꯈꯤ
নুংঙাইখ্রবা	ꯅꯨꯪꯉꯥꯏꯈꯔ꯭ꯕꯥ
নুংঙাইগদবা	ꯅꯨꯪꯉꯥꯏꯒꯗꯕꯥ
নুংঙাইজদে	ꯅꯨꯪꯉꯥꯏꯖꯗꯦ
নুংঙাইতনা	ꯅꯨꯪꯉꯥꯏꯠꯅꯥ
নুংঙাইতবগী	ꯅꯨꯡꯉꯥꯏꯇꯕꯒꯤ
নুংঙাইতবনা	ꯅꯨꯪꯉꯥꯏꯠꯕꯅꯥ
নুংঙাইতবা	ꯅꯨꯡꯉꯥꯏꯇꯕꯥ
নুংঙাইতে	ꯅꯨꯡꯉꯥꯏꯇꯦ
নুংঙাইনবা	ꯅꯨꯡꯉꯥꯏꯅꯕꯥ
নুংঙাইনা	ꯅꯨꯡꯉꯥꯏꯅꯥ
নুংঙাইব	ꯅꯨꯡꯉꯥꯏꯕ
নুংঙাইবগা	ꯅꯨꯪꯉꯥꯏꯕꯒꯥ
নুংঙাইবগী	ꯅꯨꯡꯉꯥꯏꯕꯒꯤ
নুংঙাইবনা	ꯅꯨꯪꯉꯥꯏꯕꯅꯥ
নুংঙাইবা	ꯅꯨꯡꯉꯥꯏꯕꯥ
নুংঙাইরবা	ꯅꯨꯪꯉꯥꯏꯔꯕꯥ
নুংঙাইরে	ꯅꯨꯪꯉꯥꯏꯔꯦ
নুংঙাইহন্দবা	ꯅꯨꯪꯉꯥꯏꯍꯟꯗꯕꯥ
নুংতিগী	ꯅꯨꯡꯇꯤꯒꯤ
নুংথিন	ꯅꯨꯪꯊꯤꯅ
নুংথিন্দা	ꯅꯨꯪꯊꯤꯟꯗꯥ
নুংথিল	ꯅꯨꯡꯊꯤꯂ
নুংথিলগী	ꯅꯨꯡꯊꯤꯂꯒꯤ
নুংথিলদগী	ꯅꯨꯡꯊꯤꯂꯗꯒꯤ
নুংথিলদা	ꯅꯨꯡꯊꯤꯂꯗꯥ
নুংদা	ꯅꯨꯡꯗꯥ
নুংনাংনিংঙাই	ꯅꯨꯡꯅꯥꯡꯅꯤꯡꯉꯥꯏ
নুংনাংনিঙাই	ꯅꯨꯡꯅꯥꯡꯅꯤꯉꯥꯏ
নুংনাংবশিং	ꯅꯨꯡꯅꯥꯡꯕꯁꯤꯡ
নুংনাংবা	ꯅꯨꯡꯅꯥꯡꯕꯥ
নুংবা	ꯅꯨꯡꯕꯥ
নুংশা	ꯅꯨꯡꯁꯥ
নুংশাংনা	ꯅꯨꯡꯁꯥꯡꯅꯥ
নুংশাগী	ꯅꯨꯡꯁꯥꯒꯤ
নুংশাদা	ꯅꯨꯪꯁꯥꯗꯥ
নুংশি	ꯅꯨꯡꯁꯤ
নুংশিখ্রবা	ꯅꯨꯪꯁꯤꯈꯔ꯭ꯕꯥ
নুংশিখ্রেদা	ꯅꯨꯪꯁꯤꯈꯔꯦꯗꯥ
নুংশিজরবা	ꯅꯨꯡꯁꯤꯖꯔꯕꯥ
নুংশিদুনা	ꯅꯨꯪꯁꯤꯗꯨꯅꯥ
নুংশিনদনবা	ꯅꯨꯡꯁꯤꯅꯗꯅꯕꯥ
নুংশিনদবা	ꯅꯨꯡꯁꯤꯅꯗꯕꯥ
নুংশিননবা	ꯅꯨꯡꯁꯤꯅꯅꯕꯥ
নুংশিনবগী	ꯅꯨꯡꯁꯤꯅꯕꯒꯤ
নুংশিনবা	ꯅꯨꯡꯁꯤꯅꯕꯥ
নুংশিনা	ꯅꯨꯡꯁꯤꯅꯥ
নুংশিবগা	ꯅꯨꯡꯁꯤꯕꯒꯥ
নুংশিবগী	ꯅꯨꯡꯁꯤꯕꯒꯤ
নুংশিবদগী	ꯅꯨꯪꯁꯤꯕꯗꯒꯤ
নুংশিবা	ꯅꯨꯡꯁꯤꯕꯥ
নুংশিবী	ꯅꯨꯪꯁꯤꯕꯤ
নুংশিবীদুনা	ꯅꯨꯡꯁꯤꯕꯤꯗꯨꯅꯥ
নুংশিরবা	ꯅꯨꯡꯁꯤꯔꯕꯥ
নুংশিৎ	ꯅꯨꯡꯁꯤꯠ
নুংশিৎকা	ꯅꯨꯡꯁꯤꯠꯀꯥ
নুংশিৎকী	ꯅꯨꯡꯁꯤꯠꯀꯤ
নুংশিৎতা	ꯅꯨꯡꯁꯤꯠꯇꯥ
নুংশিৎনা	ꯅꯨꯡꯁꯤꯠꯅꯥ
নুঙ	ꯅꯨꯡ
নুঙগী	ꯅꯨꯡꯒꯤ
নুঙনা	ꯅꯨꯡꯅꯥ
নুঙাইতবা	ꯅꯨꯉꯥꯏꯇꯕꯥ
নুঙাইবা	ꯅꯨꯉꯥꯏꯕꯥ
নুজা	ꯅꯨꯖꯥ
নুপা	ꯅꯨꯄꯥ
নুপাগা	ꯅꯨꯄꯥꯒꯥ
নুপাগী	ꯅꯨꯄꯥꯒꯤ
নুপাদা	ꯅꯨꯄꯥꯗꯥ
নুপাদুগা	ꯅꯨꯄꯥꯗꯨꯒꯥ
নুপাদুদা	ꯅꯨꯄꯥꯗꯨꯗꯥ
নুপানা	ꯅꯨꯄꯥꯅꯥ
নুপানি	ꯅꯨꯄꯥꯅꯤ
নুপামচা	ꯅꯨꯄꯥꯃꯆꯥ
নুপামচাগী	ꯅꯨꯄꯥꯃꯆꯥꯒꯤ
নুপাশিং	ꯅꯨꯄꯥꯁꯤꯡ
নুপাশিংগা	ꯅꯨꯄꯥꯁꯤꯡꯒꯥ
নুপাশিংদগী	ꯅꯨꯄꯥꯁꯤꯡꯗꯒꯤ
নুপাশিংনা	ꯅꯨꯄꯥꯁꯤꯡꯅꯥ
নুপাশিংবু	ꯅꯨꯄꯥꯁꯤꯪꯕꯨ
নুপাসু	ꯅꯨꯄꯥꯁꯨ
নুপী	ꯅꯨꯄꯤ
নুপীগা	ꯅꯨꯄꯤꯒꯥ
নুপীগী	ꯅꯨꯄꯤꯒꯤ
নুপীদগী	ꯅꯨꯄꯤꯗꯒꯤ
নুপীদা	ꯅꯨꯄꯤꯗꯥ
নুপীদুগী	ꯅꯨꯄꯤꯗꯨꯒꯤ
নুপীদুনা	ꯅꯨꯄꯤꯗꯨꯅꯥ
নুপীদুবু	ꯅꯨꯄꯤꯗꯨꯕꯨ
নুপীনা	ꯅꯨꯄꯤꯅꯥ
নুপীনি	ꯅꯨꯄꯤꯅꯤ
নুপীবু	ꯅꯨꯄꯤꯕꯨ
নুপীমচা	ꯅꯨꯄꯤꯃꯆꯥ
নুপীমচাগী	ꯅꯨꯄꯤꯃꯆꯥꯒꯤ
নুপীমচাদুনা	ꯅꯨꯄꯤꯃꯆꯥꯗꯨꯅꯥ
নুপীমচাশিং	ꯅꯨꯄꯤꯃꯆꯥꯁꯤꯡ
নুপীমচাশিংগী	ꯅꯨꯄꯤꯃꯆꯥꯁꯤꯡꯒꯤ
নুপীমচাশিংনা	ꯅꯨꯄꯤꯃꯆꯥꯁꯤꯡꯅꯥ
নুপীমচাশিংসু	ꯅꯨꯄꯤꯃꯆꯥꯁꯤꯡꯁꯨ
নুপীলান	ꯅꯨꯄꯤꯂꯥꯅ
নুপীশিং	ꯅꯨꯄꯤꯁꯤꯡ
নুপীশিংগা	ꯅꯨꯄꯤꯁꯤꯡꯒꯥ
নুপীশিংগী	ꯅꯨꯄꯤꯁꯤꯡꯒꯤ
নুপীশিংগীদমক	ꯅꯨꯄꯤꯁꯤꯡꯒꯤꯗꯃꯛ
নুপীশিংদগী	ꯅꯨꯄꯤꯁꯤꯡꯗꯒꯤ
নুপীশিংদা	ꯅꯨꯄꯤꯁꯤꯡꯗꯥ
নুপীশিংনা	ꯅꯨꯄꯤꯁꯤꯡꯅꯥ
নুপীশিংবু	ꯅꯨꯄꯤꯁꯤꯡꯕꯨ
নুপীশিংসু	ꯅꯨꯄꯤꯁꯤꯡꯁꯨ
নুপীসু	ꯅꯨꯄꯤꯁꯨ
নুমি	ꯅꯨꯃꯤ
নুমিত্ত	ꯅꯨꯃꯤꯠꯇ
নুমিত্তগী	ꯅꯨꯃꯤꯠꯇꯒꯤ
নুমিত্তনা	ꯅꯨꯃꯤꯠꯇꯅꯥ
নুমিত্তসু	ꯅꯨꯃꯤꯠꯇꯁꯨ
নুমিত্তা	ꯅꯨꯃꯤꯠꯇꯥ
নুমিত্তি	ꯅꯨꯃꯤꯠꯇꯤ
নুমিত্তুগী	ꯅꯨꯃꯤꯠꯇꯨꯒꯤ
নুমিত্তুদগী	ꯅꯨꯃꯤꯠꯇꯨꯗꯒꯤ
নুমিত্তুদা	ꯅꯨꯃꯤꯠꯇꯨꯗꯥ
নুমিদাং	ꯅꯨꯃꯤꯗꯥꯡ
নুমিদাংগী	ꯅꯨꯃꯤꯗꯥꯡꯒꯤ
নুমিদাংদগী	ꯅꯨꯃꯤꯗꯥꯡꯗꯒꯤ
নুমিদাংদা	ꯅꯨꯃꯤꯗꯥꯡꯗꯥ
নুমিদাংৱাই	ꯅꯨꯃꯤꯗꯥꯪꯋꯥꯏ
নুমিদাংৱাইরম	ꯅꯨꯃꯤꯗꯥꯡꯋꯥꯏꯔꯝ
নুমিদাংৱাইরমদা	ꯅꯨꯃꯤꯗꯥꯡꯋꯥꯏꯔꯝꯗꯥ
নুমিদাৱাইরম	ꯅꯨꯃꯤꯗꯥꯋꯥꯏꯔꯝ
নুমিৎ	ꯅꯨꯃꯤꯠ
নুমিৎকা	ꯅꯨꯃꯤꯠꯀꯥ
নুমিৎকী	ꯅꯨꯃꯤꯠꯀꯤ
নুমিৎতগী	ꯅꯨꯃꯤꯠꯇꯒꯤ
নুমিৎতদি	ꯅꯨꯃꯤꯠꯇꯗꯤ
নুমিৎতনা	ꯅꯨꯃꯤꯠꯇꯅꯥ
নুমিৎতসু	ꯅꯨꯃꯤꯠꯇꯁꯨ
নুমিৎতা	ꯅꯨꯃꯤꯠꯇꯥ
নুমিৎনা	ꯅꯨꯃꯤꯠꯅꯥ
নুমিৎনি	ꯅꯨꯃꯤꯠꯅꯤ
নুমিৎপু	ꯅꯨꯃꯤꯠꯄꯨ
নুমিৎশিং	ꯅꯨꯃꯤꯠꯁꯤꯡ
নুমিৎশিংদা	ꯅꯨꯃꯤꯠꯁꯤꯡꯗꯥ
নুমিৎসিদা	ꯅꯨꯃꯤꯠꯁꯤꯗꯥ
নুমিৎসু	ꯅꯨꯃꯤꯠꯁꯨ
নুমিৎয়ুংবা	ꯅꯨꯃꯤꯠꯌꯨꯡꯕꯥ
নুমীদাংৱাইরম	ꯅꯨꯃꯤꯗꯥꯡꯋꯥꯏꯔꯝ
নুমীৎ	ꯅꯨꯃꯤꯠ
নুমীৎকী	ꯅꯨꯃꯤꯠꯀꯤ
নুমীৎতা	ꯅꯨꯃꯤꯠꯇꯥ
নুরা	ꯅꯨꯔꯥ
নু্য	ꯅ꯭ꯌꯨ
নে	ꯅꯦ
নেকপা	ꯅꯦꯛꯄꯥ
নেগেটিব	ꯅꯦꯒꯦꯇꯤꯕ
নেচর	ꯅꯦꯆ꯭ꯔ
নেচরেল	ꯅꯦꯆ꯭ꯔꯦꯂ
নেটৱার্ক	ꯅꯦꯇꯥꯋꯥꯔꯛ
নেটৱার্ককী	ꯅꯦꯇꯥꯋꯥꯔꯛꯀꯤ
নেটৱার্কতা	ꯅꯦꯇꯥꯋꯥꯔꯛꯇꯥ
নেটৱার্কশিংদা	ꯅꯦꯇꯥꯋꯥꯔꯛꯁꯤꯡꯗꯥ
নেতা	ꯅꯦꯇꯥ
নেদা	ꯅꯦꯗꯥ
নেদাগী	ꯅꯦꯗꯥꯒꯤ
নেপাল	ꯅꯦꯄꯥꯜ
নেপালগা	ꯅꯦꯄꯥꯜꯒꯥ
নেপালগী	ꯅꯦꯄꯥꯜꯒꯤ
নেপালদা	ꯅꯦꯄꯥꯜꯗꯥ
নেপালনা	ꯅꯦꯄꯥꯜꯅꯥ
নেপালি	ꯅꯦꯄꯥꯂꯤ
নেপ্রম	ꯅꯦꯞꯔꯝ
নেভিগী	ꯅꯦꯚꯤꯒꯤ
নেভেল	ꯅꯦꯚꯦꯜ
নেমচা	ꯅꯦꯝꯆꯥ
নেমথরক্লে	ꯅꯦꯝꯊꯔꯛꯂꯦ
নেম্না	ꯅꯦꯝꯅꯥ
নেম্বগী	ꯅꯦꯝꯕꯒꯤ
নেম্বা	ꯅꯦꯝꯕꯥ
নেম্মী	ꯅꯦꯝꯃꯤ
নেম্লবসু	ꯅꯦꯝꯂꯕꯁꯨ
নেম্লি	ꯅꯦꯝꯂꯤ
নেরেটিব	ꯅꯦꯔꯦꯇꯤꯕ
নেলসন	ꯅꯦꯜꯁꯟ
নেসন	ꯅꯦꯁꯟ
নেসনগী	ꯅꯦꯁꯟꯒꯤ
নেসনেল	ꯅꯦꯁꯅꯦꯂ
নেসনেলদা	ꯅꯦꯁꯅꯦꯂꯗꯥ
নেসনেলিষ্ট	ꯅꯦꯁꯅꯦꯂꯤꯁꯇ
নেসন্স	ꯅꯦꯁꯟꯁ
নেসন্সকী	ꯅꯦꯁꯟꯁꯀꯤ
নেসন্সতা	ꯅꯦꯁꯟꯁꯇꯥ
নেসন্সনা	ꯅꯦꯁꯟꯁꯅꯥ
নেস্নেল	ꯅꯦꯁꯅꯦꯜ
নেস্নেলিষ্ট	ꯅꯦꯁꯅꯦꯂꯤꯁꯇ
নেহরু	ꯅꯦꯍ꯭ꯔꯨ
নৈনখি	ꯅꯩꯅꯈꯤ
নৈনখ্রে	ꯅꯩꯅꯈꯔꯦ
নৈনগদবনি	ꯅꯩꯅꯒꯗꯕꯅꯤ
নৈনদুনা	ꯅꯩꯅꯗꯨꯅꯥ
নৈননবা	ꯅꯩꯅꯟꯕꯥ
নৈনবগা	ꯅꯩꯅꯕꯒꯥ
নৈনবগী	ꯅꯩꯅꯕꯒꯤ
নৈনবদা	ꯅꯩꯅꯕꯗꯥ
নৈনবনা	ꯅꯩꯅꯕꯅꯥ
নৈনবা	ꯅꯩꯅꯕꯥ
নৈনবীয়ু	ꯅꯩꯅꯕꯤꯌꯨ
নৈনরকপদা	ꯅꯩꯅꯔꯛꯄꯗꯥ
নৈনরবা	ꯅꯩꯅꯔꯕꯥ
নৈনরি	ꯅꯩꯅꯔꯤ
নৈনরে	ꯅꯩꯅꯔꯦ
নৈফ্যু	ꯅꯩꯐ꯭ꯌꯨ
নৈবা	ꯅꯩꯕꯥ
নৈবীবা	ꯅꯩꯕꯤꯕꯥ
ন্টকী	ꯅꯥꯠꯀꯤ
ন্যু	ꯅꯌ꯭ꯨ
নৎ	ꯅꯠ
নয়া	ꯅꯌꯥ
নৱা	ꯅꯋꯥ
নৱাজ	ꯅꯋꯥꯖ
পংশিদা	ꯄꯪꯁꯤꯗꯥ
পকিষ্টানগী	ꯄꯀꯤꯁꯇ꯭ꯥꯅꯒꯤ
পকিষ্টানদা	ꯄꯀꯤꯁꯇ꯭ꯥꯅꯗꯥ
পকিষ্টাননা	ꯄꯀꯤꯁꯇ꯭ꯥꯅꯅꯥ
পঙ্গল	ꯄꯪꯒꯜ
পঞ্চায়ট	ꯄꯟꯆꯥꯌꯠ
পঞ্চায়টতা	ꯄꯟꯆꯥꯌꯠꯇꯥ
পঞ্চায়টশিংদা	ꯄꯟꯆꯥꯌꯠꯁꯤꯡꯗꯥ
পঞ্চায়েটকী	ꯄꯟꯆꯥꯌꯦꯠꯀꯤ
পঞ্জাব	ꯄꯟꯖꯥꯕ
পঞ্জাবকি	ꯄꯟꯖꯥꯕꯀꯤ
পঞ্জাবকী	ꯄꯟꯖꯥꯕꯀꯤ
পঞ্জাবগী	ꯄꯟꯖꯥꯕꯒꯤ
পঞ্জাবতা	ꯄꯟꯖꯥꯕꯇꯥ
পঞ্জাবনা	ꯄꯟꯖꯥꯕꯅꯥ
পঞ্জাল	ꯄꯟꯖꯥꯜ
পতনায়কনা	ꯄꯠꯅꯥꯌꯛꯅꯥ
পথাপ	ꯄꯊꯥꯞ
পথাপশিং	ꯄꯊꯥꯞꯁꯤꯡ
পদা	ꯄꯗꯥ
পদ্ম	ꯄꯗꯃꯥ
পদ্মশ্রী	ꯄꯗꯃꯥꯁ꯭ꯔꯤ
পদ্মা	ꯄꯗꯃꯥ
পনখি	ꯄꯟꯈꯤ
পনখৈ	ꯄꯟꯈꯩ
পনখ্রে	ꯄꯟꯈꯔꯦ
পনবগা	ꯄꯟꯕꯒꯥ
পনবদা	ꯄꯟꯕꯗꯥ
পনবা	ꯄꯟꯕꯥ
পন্থুং	ꯄꯟꯊꯨꯡ
পন্থুংফম	ꯄꯟꯊꯨꯡꯐꯝ
পন্দিত	ꯄꯟꯗꯤꯇ
পন্দুনা	ꯄꯟꯗꯨꯅꯥ
পন্দুপ	ꯄꯟꯗꯨꯞ
পব্লিক	ꯄꯕꯂꯤꯛ
পব্লিকেসন	ꯄꯕꯂꯤꯀꯦꯁꯟ
পব্লিসিটি	ꯄꯕꯂꯤꯁꯤꯇꯤ
পম্প	ꯄꯝꯄ
পম্পশিংদা	ꯄꯝꯄꯁꯤꯡꯗꯥ
পরগনাগী	ꯄꯔꯒꯅꯥꯒꯤ
পরাও	ꯄꯔꯥꯑꯣ
পরি	ꯄꯔꯤ
পরিং	ꯄꯔꯤꯡ
পরিংগী	ꯄꯔꯤꯡꯒꯤ
পরিংদগী	ꯄꯔꯤꯡꯗꯒꯤ
পরিংদা	ꯄꯔꯤꯡꯗꯥ
পরিক্ষা	ꯄꯔꯤꯛꯁꯥ
পরিক্ষাগী	ꯄꯔꯤꯛꯁꯥꯒꯤ
পরিক্ষাদা	ꯄꯔꯤꯛꯁꯥꯗꯥ
পরিক্ষাশিংদা	ꯄꯔꯤꯛꯁꯥꯁꯤꯡꯗꯥ
পরিক্ষাসু	ꯄꯔꯤꯛꯁꯥꯁꯨ
পরিষদ	ꯄꯔꯤꯁꯗ
পরিষদকী	ꯄꯔꯤꯁꯗꯀꯤ
পরিষদনসু	ꯄꯔꯤꯁꯗꯟꯁꯨ
পরিষদনা	ꯄꯔꯤꯁꯗꯅꯥ
পরেং	ꯄꯔꯦꯡ
পরেংগী	ꯄꯔꯦꯡꯒꯤ
পরেংশিং	ꯄꯔꯦꯡꯁꯤꯡ
পলি	ꯄꯂꯤ
পলেম	ꯄꯂꯦꯃ
পল্লকখিবনি	ꯄꯜꯂꯛꯈꯤꯕꯅꯤ
পল্লকপা	ꯄꯜꯂꯛꯄꯥ
পল্লদুনা	ꯄꯜꯂꯗꯨꯅꯥ
পল্লি	ꯄꯜꯂꯤ
পল্লেনদা	ꯄꯜꯂꯦꯟꯗꯥ
পল্লেল	ꯄꯜꯂꯦꯜ
পসৱান	ꯄꯁꯋꯥꯟ
পা	ꯄꯥ
পাং	ꯄꯥꯡ
পাংই	ꯄꯥꯡꯏ
পাংখি	ꯄꯥꯡꯈꯤ
পাংখিবা	ꯄꯥꯡꯈꯤꯕꯥ
পাংখ্রে	ꯄꯥꯡꯈꯔꯦ
পাংগনি	ꯄꯥꯡꯒꯅꯤ
পাংগনিসু	ꯄꯥꯡꯒꯅꯤꯁꯨ
পাংগে	ꯄꯥꯪꯒꯦ
পাংদবা	ꯄꯥꯡꯗꯕꯥ
পাংদুনা	ꯄꯥꯡꯗꯨꯅꯥ
পাংনদুনা	ꯄꯥꯡꯅꯗꯨꯅꯥ
পাংনবগী	ꯄꯥꯡꯅꯕꯒꯤ
পাংনবসু	ꯄꯥꯡꯅꯕꯁꯨ
পাংনবা	ꯄꯥꯡꯅꯕꯥ
পাংনা	ꯄꯥꯡꯅꯥ
পাংবগা	ꯄꯥꯡꯕꯒꯥ
পাংবগী	ꯄꯥꯡꯕꯒꯤ
পাংবতা	ꯄꯥꯡꯕꯇꯥ
পাংবদগী	ꯄꯥꯡꯕꯗꯒꯤ
পাংবদা	ꯄꯥꯡꯕꯗꯥ
পাংবা	ꯄꯥꯡꯕꯥ
পাংবিনবা	ꯄꯥꯡꯕꯤꯅꯕꯥ
পাংবিয়ু	ꯄꯥꯡꯕꯤꯌꯨ
পাংবীখি	ꯄꯥꯡꯕꯤꯈꯤ
পাংবীনবা	ꯄꯥꯡꯕꯤꯅꯕꯥ
পাংবীবা	ꯄꯥꯡꯕꯤꯕꯥ
পাংবীয়ু	ꯄꯥꯡꯕꯤꯌꯨ
পাংলকপদা	ꯄꯥꯡꯂꯛꯄꯗꯥ
পাংলক্লে	ꯄꯥꯪꯂꯛꯂꯦ
পাংলগনি	ꯄꯥꯡꯂꯒꯅꯤ
পাংলি	ꯄꯥꯡꯂꯤ
পাংলিবা	ꯄꯥꯡꯂꯤꯕꯥ
পাংশিনবা	ꯄꯥꯡꯁꯤꯟꯕꯥ
পাইখি	ꯄꯥꯏꯈꯤ
পাইখ্রে	ꯄꯥꯏꯈꯔꯦ
পাইখৎপা	ꯄꯥꯏꯈꯠꯄꯥ
পাইগদবা	ꯄꯥꯏꯒꯗꯕꯥ
পাইতে	ꯄꯥꯏꯇꯦ
পাইদুনা	ꯄꯥꯏꯗꯨꯅꯥ
পাইন	ꯄꯥꯏꯅꯥ
পাইনবা	ꯄꯥꯏꯅꯕꯥ
পাইনা	ꯄꯥꯏꯅꯥ
পাইপ	ꯄꯥꯏꯞ
পাইবা	ꯄꯥꯏꯕꯥ
পাইরকপা	ꯄꯥꯏꯔꯛꯄꯥ
পাইরক্কী	ꯄꯥꯏꯔꯛꯀꯤ
পাইরক্লিবা	ꯄꯥꯏꯔꯛꯂꯤꯕꯥ
পাইরম্বা	ꯄꯥꯏꯔꯝꯕꯥ
পাইরিবা	ꯄꯥꯏꯔꯤꯕꯥ
পাইরে	ꯄꯥꯏꯔꯦ
পাইহন্নবা	ꯄꯥꯏꯍꯟꯅꯕꯥ
পাও	ꯄꯥꯑꯣ
পাওনম	ꯄꯥꯑꯣꯅꯝ
পাওনা	ꯄꯥꯑꯣꯅꯥ
পাক	ꯄꯥꯛ
পাকই	ꯄꯥꯛꯏ
পাকখি	ꯄꯥꯛꯈꯤ
পাকখিদ্রে	ꯄꯥꯛꯈꯤꯗꯔꯦ
পাকখিবগা	ꯄꯥꯛꯈꯤꯕꯒꯥ
পাকখিবগী	ꯄꯥꯛꯈꯤꯕꯒꯤ
পাকখিবনি	ꯄꯥꯛꯈꯤꯕꯅꯤ
পাকখিবশিং	ꯄꯥꯛꯈꯤꯕꯁꯤꯡ
পাকখিবা	ꯄꯥꯛꯈꯤꯕꯥ
পাকখ্রবনি	ꯄꯥꯛꯈꯔ꯭ꯕꯅꯤ
পাকখ্রবসু	ꯄꯥꯀꯈꯔ꯭ꯕꯁꯨ
পাকখ্রবা	ꯄꯥꯛꯈꯔ꯭ꯕꯥ
পাকখ্রে	ꯄꯥꯀꯈꯔꯦ
পাকপগা	ꯄꯥꯛꯄꯒꯥ
পাকপগী	ꯄꯥꯛꯄꯒꯤ
পাকপদা	ꯄꯥꯛꯄꯗꯥ
পাকপনি	ꯄꯥꯛꯄꯅꯤ
পাকপা	ꯄꯥꯛꯄꯥ
পাকশন্না	ꯄꯥꯛꯁꯟꯅꯥ
পাকহনবদা	ꯄꯥꯛꯍꯟꯕꯗꯥ
পাকহনবা	ꯄꯥꯛꯍꯟꯕꯥ
পাকহন্ননবা	ꯄꯥꯛꯍꯟꯅꯅꯕꯥ
পাকহন্নবা	ꯄꯥꯛꯍꯟꯅꯕꯥ
পাক্কদবা	ꯄꯥꯛꯀꯗꯕꯥ
পাক্কনি	ꯄꯥꯛꯀꯅꯤ
পাক্ননবা	ꯄꯥꯛꯅꯅꯕꯥ
পাক্নবগী	ꯄꯥꯛꯅꯕꯒꯤ
পাক্নবগীদমক	ꯄꯥꯛꯅꯕꯒꯤꯗꯃꯛ
পাক্নবা	ꯄꯥꯛꯅꯕꯥ
পাক্না	ꯄꯥꯛꯅꯥ
পাক্লকখিবা	ꯄꯥꯛꯂꯛꯈꯤꯕꯥ
পাক্লকখ্রবা	ꯄꯥꯛꯂꯛꯈꯔ꯭ꯕꯥ
পাক্লকপদা	ꯄꯥꯛꯂꯛꯄꯗꯥ
পাক্লকপা	ꯄꯥꯛꯂꯛꯄꯥ
পাক্লক্লবা	ꯄꯥꯛꯂꯛꯂꯕꯥ
পাক্লগনি	ꯄꯥꯛꯂ꯭ꯒꯅꯤ
পাক্লবদি	ꯄꯥꯛꯂ꯭ꯕꯗꯤ
পাক্লবা	ꯄꯥꯡꯂ꯭ꯕꯥ
পাক্লি	ꯄꯥꯛꯂꯤ
পাক্লে	ꯄꯥꯛꯂꯦ
পাখং	ꯄꯥꯈꯪ
পাখংবা	ꯄꯥꯈꯪꯕꯥ
পাখংলাকপা	ꯄꯥꯈꯪꯂꯥꯛꯄꯥ
পাখঙ	ꯄꯥꯈꯪ
পাখঙলাকপা	ꯄꯥꯈꯪꯂꯥꯛꯄꯥ
পাখিবা	ꯄꯥꯈꯤꯕꯥ
পাখৎনিংঙাই	ꯄꯥꯈꯠꯅꯤꯡꯉꯥꯏ
পাখৎপা	ꯄꯥꯈꯠꯄꯥ
পাঙম্বম	ꯄꯥꯉꯝꯕꯝ
পাঙল	ꯄꯥꯉꯜ
পাঙলগী	ꯄꯥꯉꯜꯒꯤ
পাঙ্গল	ꯄꯥꯡꯒꯜ
পাঙ্গলনা	ꯄꯥꯡꯒꯜꯅꯥ
পাঙ্গলনি	ꯄꯥꯡꯒꯜꯅꯤ
পাঞ্জন	ꯄꯥꯟꯖꯟ
পাঞ্জি	ꯄꯥꯟꯖꯤ
পাঞ্জিনা	ꯄꯥꯟꯖꯤꯅꯥ
পাটা	ꯄꯥꯇꯥ
পাটিল	ꯄꯥꯇꯤꯂ
পাটেলগী	ꯄꯥꯇꯦꯂꯒꯤ
পাটেলনা	ꯄꯥꯇꯦꯂꯅꯥ
পাতিল	ꯄꯥꯇꯤꯂꯜ
পাতেল	ꯄꯥꯇꯦꯜ
পাতেলনা	ꯄꯥꯇꯦꯜꯅꯥ
পাত্তা	ꯄꯥꯠꯇꯥ
পাথরকপা	ꯄꯥꯊꯔꯛꯄꯥ
পাদবা	ꯄꯥꯗꯕꯥ
পাদুনা	ꯄꯥꯗꯨꯅꯥ
পান	ꯄꯥꯅ
পানখ্রবা	ꯄꯥꯅꯈꯔ꯭ꯕꯥ
পানখ্রবী	ꯄꯥꯅꯈꯔ꯭ꯕꯤ
পানগনি	ꯄꯥꯅꯒꯅꯤ
পানদুনা	ꯄꯥꯅꯗꯨꯅꯥ
পানবগী	ꯄꯥꯅꯕꯒꯤ
পানবদগী	ꯄꯥꯅꯕꯗꯒꯤ
পানবদা	ꯄꯥꯅꯕꯗꯥ
পানবা	ꯄꯥꯅꯕꯥ
পানমৈনা	ꯄꯥꯅꯃꯩꯅꯥ
পানরম্বদগী	ꯄꯥꯅꯔꯝꯕꯗꯒꯤ
পানরি	ꯄꯥꯅꯔꯤ
পানরিবা	ꯄꯥꯅꯔꯤꯕꯥ
পানা	ꯄꯥꯅꯥ
পানি	ꯄꯥꯅꯤ
পান্থা	ꯄꯥꯟꯊꯥ
পান্থৈ	ꯄꯥꯟꯊꯩ
পান্দবগুম	ꯄꯥꯟꯗꯕꯒꯨꯃ
পান্দম	ꯄꯥꯟꯗꯝ
পান্দমগা	ꯄꯥꯟꯗꯝꯒꯥ
পান্দমগী	ꯄꯥꯟꯗꯝꯒꯤ
পান্দমদনি	ꯄꯥꯟꯗꯝꯗꯅꯤ
পান্দমদা	ꯄꯥꯟꯗꯝꯗꯥ
পান্দমদি	ꯄꯥꯟꯗꯝꯗꯤ
পান্দমদু	ꯄꯥꯟꯗꯝꯗꯨ
পান্দমনি	ꯄꯥꯟꯗꯝꯅꯤ
পান্দমশিং	ꯄꯥꯟꯗꯝꯁꯤꯡ
পান্দু	ꯄꯥꯟꯗꯨ
পান্দুনা	ꯄꯥꯟꯗꯨꯅꯥ
পান্দুম	ꯄꯥꯟꯗꯨꯃ
পান্দে	ꯄꯥꯟꯗꯦ
পান্দেগী	ꯄꯥꯟꯗꯦꯒꯤ
পান্নখিবা	ꯄꯥꯟꯅꯈꯤꯕꯥ
পান্নবা	ꯄꯥꯟꯅꯕꯥ
পান্নরিবা	ꯄꯥꯟꯅꯔꯤꯕꯥ
পান্না	ꯄꯥꯟꯅꯥ
পাপ	ꯄꯥꯄ
পাফের্ামেন্স	ꯄꯥꯐꯣꯔꯃꯦꯟꯁ
পাবগী	ꯄꯥꯕꯒꯤ
পাবদা	ꯄꯥꯕꯗꯥ
পাবা	ꯄꯥꯕꯥ
পাবীয়ু	ꯄꯥꯕꯤꯌꯨ
পাবুংনা	ꯄꯥꯕꯨꯪꯅꯥ
পাম	ꯄꯥꯝ
পামখি	ꯄꯥꯝꯈꯤ
পামজবা	ꯄꯥꯝꯖꯕꯥ
পামজরম্বা	ꯄꯥꯃꯖꯔꯝꯕꯥ
পামজৈ	ꯄꯥꯃꯖꯩ
পামদবগী	ꯄꯥꯝꯗꯕꯒꯤ
পামদবা	ꯄꯥꯝꯗꯕꯥ
পামদে	ꯄꯥꯃꯗꯦ
পামে	ꯄꯥꯃꯦ
পামেল	ꯄꯥꯃꯦꯂ
পাম্নখিবা	ꯄꯥꯝꯅꯈꯤꯕꯥ
পাম্ননবা	ꯄꯥꯝꯅꯟꯕꯥ
পাম্ননা	ꯄꯥꯝꯅꯅꯥ
পাম্নবগী	ꯄꯥꯝꯅꯕꯒꯤ
পাম্নবা	ꯄꯥꯝꯅꯕꯥ
পাম্নরক্লি	ꯄꯥꯝꯅꯔꯛꯂꯤ
পাম্নরবা	ꯄꯥꯝꯅꯔꯕꯥ
পাম্নরি	ꯄꯥꯝꯅꯔꯤ
পাম্নরিবা	ꯄꯥꯝꯅꯔꯤꯕꯥ
পাম্নহন্নবা	ꯄꯥꯝꯅꯍꯟꯅꯕꯥ
পাম্না	ꯄꯥꯝꯅꯥ
পাম্নৈ	ꯄꯥꯝꯅꯩ
পাম্বা	ꯄꯥꯝꯕꯥ
পাম্বী	ꯄꯥꯝꯕꯤ
পাম্বীগী	ꯄꯥꯝꯕꯤꯒꯤ
পাম্বীবা	ꯄꯥꯝꯕꯤꯕꯥ
পাম্বীশিং	ꯄꯥꯝꯕꯤꯁꯤꯡ
পাম্বীশিংনা	ꯄꯥꯝꯕꯤꯁꯤꯪꯅꯥ
পাম্বৈ	ꯄꯥꯝꯕꯩ
পাম্বৈদি	ꯄꯥꯝꯕꯩꯗꯤ
পাম্বৈনা	ꯄꯥꯝꯕꯩꯅꯥ
পাম্বৈনি	ꯄꯥꯝꯕꯩꯅꯤ
পাম্বৈশিং	ꯄꯥꯝꯕꯩꯁꯤꯡ
পাম্বৈশিংদি	ꯄꯥꯝꯕꯩꯁꯤꯡꯗꯤ
পাম্বৈসু	ꯄꯥꯝꯕꯩꯁꯨ
পাম্মি	ꯄꯥꯝꯃꯤ
পাম্মী	ꯄꯥꯝꯃꯤ
পাম্মুখ্রেদা	ꯄꯥꯝꯃꯨꯈꯔꯦꯗꯥ
পাম্মুবা	ꯄꯥꯝꯃꯨꯕꯥ
পাম্লবসু	ꯄꯥꯝꯂꯕꯁꯨ
পাম্লম্মী	ꯄꯥꯝꯂꯝꯃꯤ
পাম্লি	ꯄꯥꯝꯂꯤ
পাম্লিবা	ꯄꯥꯝꯂꯤꯕꯥ
পাম্লে	ꯄꯥꯝꯂꯦ
পার	ꯄꯥꯔ
পারগা	ꯄꯥꯔꯒꯥ
পারা	ꯄꯥꯔꯥ
পারি	ꯄꯥꯔꯤ
পারী	ꯄꯥꯔꯤ
পার্ক	ꯄꯥꯔꯛ
পার্ককী	ꯄꯥꯔꯛꯀꯤ
পার্কতা	ꯄꯥꯔꯛꯇꯥ
পার্কনচিংবা	ꯄꯥꯔꯛꯅꯆꯤꯡꯕꯥ
পার্কশিং	ꯄꯥꯔꯛꯁꯤꯡ
পার্কিং	ꯄꯥꯔꯛꯀꯤ
পার্ট	ꯄꯥꯔꯇ
পার্টনর	ꯄꯥꯔꯇꯟꯔ
পার্টি	ꯄꯥꯔꯇꯤ
পার্টিগা	ꯄꯥꯔꯇꯤꯒꯥ
পার্টিগী	ꯄꯥꯔꯇꯤꯒꯤ
পার্টিনসু	ꯄꯥꯔꯇꯤꯅꯁꯨ
পার্টিনা	ꯄꯥꯔꯇꯤꯅꯥ
পার্টিশিং	ꯄꯥꯔꯇꯤꯁꯤꯡ
পার্টিশিংগা	ꯄꯥꯔꯇꯤꯁꯤꯡꯒꯥ
পার্টিশিংগী	ꯄꯥꯔꯇꯤꯁꯤꯡꯒꯤ
পার্টিশিংনা	ꯄꯥꯔꯇꯤꯁꯤꯡꯅꯥ
পার্তিগী	ꯄꯥꯔꯇꯤꯒꯤ
পার্মিট	ꯄꯥꯔꯃꯤꯇ
পার্মিটকী	ꯄꯥꯔꯃꯤꯇꯀꯤ
পার্মিসন	ꯄꯥꯔꯃꯤꯁꯟ
পার্মিৎ	ꯄꯥꯔꯃꯤꯠ
পার্মেনেন্ট	ꯄꯥꯔꯃꯦꯅꯦꯟꯇ
পার্লিয়মেন্টরি	ꯄꯥꯔꯂꯤꯌꯃꯦꯟꯇꯔꯤ
পার্লিয়ামেন্ট	ꯄꯥꯔꯂꯤꯌꯥꯃꯦꯟꯇ
পার্লিয়ামেন্টকী	ꯄꯥꯔꯂꯤꯌꯥꯃꯦꯟꯇꯀꯤ
পার্লিয়ামেন্টতা	ꯄꯥꯔꯂꯤꯌꯥꯃꯦꯟꯇꯇꯥ
পার্লিয়ামেন্টনা	ꯄꯥꯔꯂꯤꯌꯥꯃꯦꯟꯇꯅꯥ
পার্লিয়ামেন্টরি	ꯄꯥꯔꯂꯤꯌꯥꯃꯦꯟꯇꯔꯤ
পার্স	ꯄꯥꯔꯁ
পার্সন	ꯄꯥꯔꯁꯟ
পার্সনশিং	ꯄꯥꯔꯁꯟꯁꯤꯡ
পার্সনশিংগী	ꯄꯥꯔꯁꯟꯁꯤꯡꯒꯤ
পার্সনশিংনা	ꯄꯥꯔꯁꯟꯁꯤꯡꯅꯥ
পার্সনেল	ꯄꯥꯔꯁꯅꯦꯂ
পার্সনেলশিং	ꯄꯥꯔꯁꯅꯦꯂꯁꯤꯡ
পার্সনেলশিংগী	ꯄꯥꯔꯁꯅꯦꯂꯁꯤꯡꯒꯤ
পার্সনেলশিংদা	ꯄꯥꯔꯁꯅꯦꯂꯁꯤꯡꯗꯥ
পার্সনেলশিংনা	ꯄꯥꯔꯁꯅꯦꯂꯁꯤꯡꯅꯥ
পার্সন্স	ꯄꯥꯔꯁꯟꯁ
পালন	ꯄꯥꯂꯟ
পালর	ꯄꯥꯂꯔ
পালা	ꯄꯥꯂꯥ
পালিন	ꯄꯥꯂꯤꯅ
পাল্লকপা	ꯄꯥꯜꯂꯛꯄꯥ
পাল্লবা	ꯄꯥꯜꯂꯕꯥ
পাল্লম্বা	ꯄꯥꯜꯂꯝꯕꯥ
পাল্লি	ꯄꯥꯜꯂꯤ
পাল্লিঙৈ	ꯄꯥꯜꯂꯤꯉꯩ
পাল্লিবা	ꯄꯥꯜꯂꯤꯕꯥ
পাল্লুরে	ꯄꯥꯜꯂꯨꯔꯦ
পাস	ꯄꯥꯁ
পাসকী	ꯄꯥꯁꯀꯤ
পাসিঘাট	ꯄꯥꯁꯤꯘꯥꯇ
পাসৱান	ꯄꯥꯁꯋꯥꯅ
পাৎ	ꯄꯥꯠ
পাৎকী	ꯄꯥꯠꯀꯤ
পাৎতা	ꯄꯥꯠꯇꯥ
পাৎশিং	ꯄꯥꯠꯁꯤꯡ
পায়	ꯄꯥꯏ
পায়খি	ꯄꯥꯏꯈꯤ
পায়খিবনি	ꯄꯥꯏꯈꯤꯕꯅꯤ
পায়খ্রে	ꯄꯥꯏꯈꯔꯦ
পায়খৎকদগে	ꯄꯥꯏꯈꯠꯀꯗꯒꯦ
পায়খৎকদবনি	ꯄꯥꯏꯈꯠꯀꯗꯕꯅꯤ
পায়খৎকদবা	ꯄꯥꯏꯈꯠꯀꯗꯕꯥ
পায়খৎকনি	ꯄꯥꯏꯈꯠꯀꯅꯤ
পায়খৎখি	ꯄꯥꯏꯈꯠꯈꯤ
পায়খৎখিবা	ꯄꯥꯏꯈꯠꯈꯤꯕꯥ
পায়খৎতুনা	ꯄꯥꯏꯈꯠꯇꯨꯅꯥ
পায়খৎনবগী	ꯄꯥꯏꯈꯠꯅꯕꯒꯤ
পায়খৎনবা	ꯄꯥꯏꯈꯠꯅꯕꯥ
পায়খৎপগী	ꯄꯥꯏꯈꯠꯄꯒꯤ
পায়খৎপগীদমক	ꯄꯥꯏꯈꯠꯄꯒꯤꯗꯃꯛ
পায়খৎপদগী	ꯄꯥꯏꯈꯠꯄꯗꯒꯤ
পায়খৎপনা	ꯄꯥꯏꯈꯠꯄꯅꯥ
পায়খৎপনি	ꯄꯥꯏꯈꯠꯄꯅꯤ
পায়খৎপা	ꯄꯥꯏꯈꯠꯄꯥ
পায়খৎফম	ꯄꯥꯏꯈꯠꯐꯝ
পায়খৎলকপগী	ꯄꯥꯏꯈꯠꯂꯛꯄꯒꯤ
পায়খৎলকপদা	ꯄꯥꯏꯈꯠꯂꯛꯄꯗꯥ
পায়খৎলকপা	ꯄꯥꯏꯈꯠꯂꯛꯄꯥ
পায়খৎলক্কনি	ꯄꯥꯏꯈꯠꯂꯛꯀꯅꯤ
পায়খৎলক্লিবা	ꯄꯥꯏꯈꯠꯂꯛꯂꯤꯕꯥ
পায়খৎলগনি	ꯄꯥꯏꯈꯠꯂꯒꯅꯤ
পায়খৎলমদে	ꯄꯥꯏꯈꯠꯂꯝꯗꯦ
পায়খৎলম্বা	ꯄꯥꯏꯈꯠꯂꯝꯕꯥ
পায়খৎলি	ꯄꯥꯏꯈꯠꯂꯤ
পায়খৎলিঙৈ	ꯄꯥꯏꯈꯠꯂꯤꯉꯩ
পায়খৎলিবগে	ꯄꯥꯏꯈꯠꯂꯤꯕꯒꯦ
পায়খৎলিবা	ꯄꯥꯏꯈꯠꯂꯤꯕꯥ
পায়খৎলে	ꯄꯥꯏꯈꯠꯂꯦ
পায়খৎহন্নিংবগী	ꯄꯥꯏꯈꯠꯍꯟꯅꯤꯡꯕꯒꯤ
পায়গনি	ꯄꯥꯏꯒꯅꯤ
পায়দনা	ꯄꯥꯌꯗꯅꯥ
পায়দবা	ꯄꯥꯏꯗꯕꯥ
পায়দুনা	ꯄꯥꯏꯗꯨꯅꯥ
পায়ননবা	ꯄꯥꯏꯅꯅꯕꯥ
পায়নবা	ꯄꯥꯏꯅꯕꯥ
পায়বগা	ꯄꯥꯏꯕꯒꯥ
পায়বগী	ꯄꯥꯏꯕꯒꯤ
পায়বদা	ꯄꯥꯏꯕꯗꯥ
পায়বশিং	ꯄꯥꯏꯕꯁꯤꯡ
পায়বশিংনা	ꯄꯥꯏꯕꯁꯤꯡꯅꯥ
পায়বা	ꯄꯥꯏꯕꯥ
পায়বী	ꯄꯥꯏꯕꯤ
পায়রকপদগী	ꯄꯥꯏꯔꯛꯄꯗꯒꯤ
পায়রগা	ꯄꯥꯏꯔꯒꯥ
পায়রবদি	ꯄꯥꯏꯔꯕꯗꯤ
পায়রবা	ꯄꯥꯌꯔꯕꯥ
পায়রম্মী	ꯄꯥꯏꯔꯝꯃꯤ
পায়রি	ꯄꯥꯏꯔꯤ
পায়রিঙৈ	ꯄꯥꯏꯔꯤꯉꯩ
পায়রিবা	ꯄꯥꯏꯔꯤꯕꯥ
পায়রে	ꯄꯥꯌꯔꯦ
পায়হনবা	ꯄꯥꯏꯍꯟꯕꯥ
পাৱন	ꯄꯥꯋꯅ
পি	ꯄꯤ
পিএম	ꯄꯤꯑꯦꯡ
পিওন	ꯄꯤꯑꯣꯟ
পিওনদগী	ꯄꯤꯑꯣꯟꯗꯒꯤ
পিক	ꯄꯤꯛ
পিক্নিক	ꯄꯤꯛꯅꯤꯛ
পিখি	ꯄꯤꯈꯤ
পিগী	ꯄꯤꯒꯤ
পিঙ্ক	ꯄꯤꯡꯀ
পিছ	ꯄꯤ
পিটর	ꯄꯤꯇꯔ
পিটরনা	ꯄꯤꯇꯔꯅꯥ
পিটিআই	ꯄꯤꯇꯤꯑꯥꯏ
পিটিসনগী	ꯄꯤꯇꯤꯁꯟꯒꯤ
পিটিসনর	ꯄꯤꯇꯤꯁꯅ꯭ꯔ
পিদা	ꯄꯤꯗꯥ
পিদি	ꯄꯤꯗꯤ
পিন	ꯄꯤꯟ
পিনবা	ꯄꯤꯅꯕꯥ
পিনা	ꯄꯤꯅꯥ
পিনারায়ি	ꯄꯤꯅꯥꯔꯥꯌꯤ
পিনি	ꯄꯤꯅꯤ
পিপল	ꯄꯤꯄꯜ
পিপলস	ꯄꯤꯄꯜꯁ
পিবা	ꯄꯤꯕꯥ
পিরি	ꯄꯤꯔꯤ
পিশক	ꯄꯤꯁꯛ
পিশিনখিবা	ꯄꯤꯁꯤꯅꯈꯤꯕꯥ
পিশুম	ꯄꯤꯁꯨꯝ
পিস	ꯄꯤꯁ
পিয়ুস	ꯄꯤꯌꯨꯁ
পী	ꯄꯤ
পীক	ꯄꯤꯛ
পীকখ্রবা	ꯄꯤꯛꯈꯔ꯭ꯕꯥ
পীকচরবসু	ꯄꯤꯛꯆꯔꯕꯁꯨ
পীকপা	ꯄꯤꯛꯄꯥ
পীক্না	ꯄꯤꯛꯅꯥ
পীক্লবা	ꯄꯤꯀꯂ꯭ꯕꯥ
পীক্লিঙৈদগী	ꯄꯤꯛꯂꯤꯉꯩꯗꯒꯤ
পীক্লিবা	ꯄꯤꯛꯂꯤꯕꯥ
পীখি	ꯄꯤꯈꯤ
পীখিগনি	ꯄꯤꯈꯤꯒꯅꯤ
পীখিদে	ꯄꯤꯈꯤꯗꯦ
পীখিবগা	ꯄꯤꯈꯤꯕꯒꯥ
পীখিবগী	ꯄꯤꯈꯤꯕꯒꯤ
পীখিবনি	ꯄꯤꯈꯤꯕꯅꯤ
পীখিবা	ꯄꯤꯈꯤꯕꯥ
পীখ্রবনি	ꯄꯤꯈꯔ꯭ꯕꯅꯤ
পীখ্রবসু	ꯄꯤꯈꯔ꯭ꯕꯁꯨ
পীখ্রবা	ꯄꯤꯈꯔ꯭ꯕꯥ
পীখ্রে	ꯄꯤꯈꯔꯦ
পীখৎকদবনি	ꯄꯤꯈꯠꯀꯗꯕꯅꯤ
পীখৎকনি	ꯄꯤꯈꯠꯀꯅꯤ
পীখৎখি	ꯄꯤꯈꯠꯈꯤ
পীখৎপা	ꯄꯤꯈꯠꯄꯥ
পীখৎলকখিবা	ꯄꯤꯈꯠꯂꯛꯈꯤꯕꯥ
পীখৎলকপা	ꯄꯤꯈꯠꯂꯛꯄꯥ
পীখৎলক্নবসু	ꯄꯤꯈꯠꯂꯛꯅꯕꯁꯨ
পীখৎলক্নবা	ꯄꯤꯈꯠꯂꯛꯅꯕꯥ
পীগদবনি	ꯄꯤꯒꯗꯕꯅꯤ
পীগদবা	ꯄꯤꯒꯗꯕꯥ
পীগদ্রা	ꯄꯤꯒꯗꯔꯥ
পীগনি	ꯄꯤꯒꯅꯤ
পীগে	ꯄꯤꯒꯦ
পীজ	ꯄꯤꯖꯥ
পীজগে	ꯄꯤꯖꯒꯦ
পীজবগী	ꯄꯤꯖꯕꯒꯤ
পীজবনি	ꯄꯤꯖꯕꯅꯤ
পীজবা	ꯄꯤꯖꯕꯥ
পীজরগা	ꯄꯤꯖꯔꯒꯥ
পীজরে	ꯄꯤꯖꯔꯦ
পীথক	ꯄꯤꯊꯛ
পীদনবা	ꯄꯤꯗꯅꯕꯥ
পীদনা	ꯄꯤꯗꯅꯥ
পীদবগী	ꯄꯤꯗꯕꯒꯤ
পীদবা	ꯄꯤꯗꯕꯥ
পীদুনা	ꯄꯤꯗꯨꯅꯥ
পীদে	ꯄꯤꯗꯦ
পীদ্রবদি	ꯄꯤꯗꯔ꯭ꯕꯗꯤ
পীদ্রি	ꯄꯤꯗꯔꯤ
পীদ্রিবা	ꯄꯤꯗꯔꯤꯕꯥ
পীদ্রে	ꯄꯤꯗꯔꯦ
পীনদুনা	ꯄꯤꯅꯗꯨꯅꯥ
পীননবসু	ꯄꯤꯅꯅꯕꯁꯨ
পীননবা	ꯄꯤꯅꯅꯕꯥ
পীনবগী	ꯄꯤꯅꯕꯒꯤ
পীনবগীদমক	ꯄꯤꯅꯕꯒꯤꯗꯃꯛ
পীনবনি	ꯄꯤꯅꯕꯅꯤ
পীনবসু	ꯄꯤꯅꯕꯁꯨ
পীনবা	ꯄꯤꯅꯕꯥ
পীনবীয়ু	ꯄꯤꯟꯕꯤꯌꯨ
পীনরক্লি	ꯄꯤꯅꯔꯛꯂꯤ
পীনরি	ꯄꯤꯅꯔꯤ
পীনরিবা	ꯄꯤꯅꯔꯤꯕꯥ
পীনিংবা	ꯄꯤꯅꯤꯡꯕꯥ
পীফম	ꯄꯤꯐꯝ
পীবগা	ꯄꯤꯕꯒꯥ
পীবগী	ꯄꯤꯕꯒꯤ
পীবতা	ꯄꯤꯕꯇꯥ
পীবদগী	ꯄꯤꯕꯗꯒꯤ
পীবদা	ꯄꯤꯕꯗꯥ
পীবদি	ꯄꯤꯕꯗꯤ
পীবদুনি	ꯄꯤꯕꯗꯨꯅꯤ
পীবনা	ꯄꯤꯕꯅꯥ
পীবনি	ꯄꯤꯕꯅꯤ
পীবসু	ꯄꯤꯕꯁꯨ
পীবা	ꯄꯤꯕꯥ
পীবিদবা	ꯄꯤꯕꯤꯗꯕꯥ
পীবিনবা	ꯄꯤꯕꯤꯅꯕꯥ
পীবিবা	ꯄꯤꯕꯤꯕꯥ
পীবিরগা	ꯄꯤꯕꯤꯔꯒꯥ
পীবিয়ু	ꯄꯤꯕꯤꯌꯨ
পীবীদুনা	ꯄꯤꯕꯤꯗꯨꯅꯥ
পীবীনবা	ꯄꯤꯕꯤꯅꯕꯥ
পীবীয়ু	ꯄꯤꯕꯤꯌꯨ
পীরকই	ꯄꯤꯔꯛꯏ
পীরকখি	ꯄꯤꯔꯛꯈꯤ
পীরকখিবনি	ꯄꯤꯔꯛꯈꯤꯕꯅꯤ
পীরকখিবা	ꯄꯤꯔꯛꯈꯤꯕꯥ
পীরকখ্রে	ꯄꯤꯔꯛꯈꯔꯦ
পীরকপগা	ꯄꯤꯔꯛꯄꯒꯥ
পীরকপগী	ꯄꯤꯔꯛꯄꯒꯤ
পীরকপদগী	ꯄꯤꯔꯛꯄꯗꯒꯤ
পীরকপদা	ꯄꯤꯔꯛꯄꯗꯥ
পীরকপনি	ꯄꯤꯔꯛꯄꯅꯤ
পীরকপা	ꯄꯤꯔꯛꯄꯥ
পীরক্কদবা	ꯄꯤꯔꯛꯀꯗꯕꯥ
পীরক্কনি	ꯄꯤꯔꯛꯀꯅꯤ
পীরক্নবসু	ꯄꯤꯔꯛꯅꯕꯁꯨ
পীরক্নবা	ꯄꯤꯔꯛꯅꯕꯥ
পীরক্লগা	ꯄꯤꯔꯛꯂꯒꯥ
পীরক্লবদি	ꯄꯤꯔꯛꯂꯕꯗꯤ
পীরক্লিবা	ꯄꯤꯔꯛꯂꯤꯕꯥ
পীরক্লে	ꯄꯤꯔꯛꯂꯦ
পীরগদি	ꯄꯤꯔꯒꯗꯤ
পীরগনি	ꯄꯤꯔꯒꯅꯤ
পীরগা	ꯄꯤꯔꯒꯥ
পীরগে	ꯄꯤꯔꯒꯦ
পীরদুনা	ꯄꯤꯔꯗꯨꯅꯥ
পীরবদি	ꯄꯤꯔꯕꯗꯤ
পীরবসু	ꯄꯤꯔꯕꯁꯨ
পীরবা	ꯄꯤꯔꯕꯥ
পীরমখি	ꯄꯤꯔꯝꯈꯤ
পীরমখিবা	ꯄꯤꯔꯝꯈꯤꯕꯥ
পীরম্বদু	ꯄꯤꯔꯝꯕꯗꯨ
পীরম্বা	ꯄꯤꯔꯝꯕꯥ
পীরম্মি	ꯄꯤꯔꯝꯃꯤ
পীরম্মী	ꯄꯤꯔꯝꯃꯤ
পীরম্লগা	ꯄꯤꯔꯝꯂꯒꯥ
পীরসি	ꯄꯤꯔꯁꯤ
পীরি	ꯄꯤꯔꯤ
পীরিবশিং	ꯄꯤꯔꯤꯕꯁꯤꯡ
পীরিবা	ꯄꯤꯔꯤꯕꯥ
পীরে	ꯄꯤꯔꯦ
পীশিন	ꯄꯤꯁꯤꯅ
পীশিনখি	ꯄꯤꯁꯤꯅꯈꯤ
পীশিনখিবনি	ꯄꯤꯁꯤꯅꯈꯤꯕꯅꯤ
পীশিনখিবা	ꯄꯤꯁꯤꯅꯈꯤꯕꯥ
পীশিনখ্রে	ꯄꯤꯁꯤꯅꯈꯔꯦ
পীশিনবগী	ꯄꯤꯁꯤꯅꯕꯒꯤ
পীশিনবদা	ꯄꯤꯁꯤꯅꯕꯗꯥ
পীশিনবা	ꯄꯤꯁꯤꯅꯕꯥ
পীশিন্দুনা	ꯄꯤꯁꯤꯟꯗꯨꯅꯥ
পীশিল্লকখিবা	ꯄꯤꯁꯤꯜꯂꯛꯈꯤꯕꯥ
পীশিল্লকপা	ꯄꯤꯁꯤꯜꯂꯛꯄꯥ
পীশিল্লগনি	ꯄꯤꯁꯤꯜꯂꯒꯅꯤ
পীয়ু	ꯄꯤꯌꯨ
পু	ꯄꯨ
পুং	ꯄꯨꯡ
পুংফম	ꯄꯨꯡꯐꯝ
পুংবা	ꯄꯨꯡꯕꯥ
পুংলেপ	ꯄꯨꯡꯂꯦꯞ
পুই	ꯄꯨꯏ
পুইচি	ꯄꯨꯏꯆꯤ
পুকচেল	ꯄꯨꯛꯆꯦꯜ
পুক্কৈ	ꯄꯨꯛꯀꯩ
পুক্কৈনি	ꯄꯨꯛꯀꯩꯅꯤ
পুক্নিং	ꯄꯨꯛꯅꯤꯡ
পুক্নিংগী	ꯄꯨꯛꯅꯤꯡꯒꯤ
পুখত্তুনা	ꯄꯨꯈꯠꯇꯨꯅꯥ
পুখম	ꯄꯨꯈꯝ
পুখরে	ꯄꯨꯈꯔꯦ
পুখি	ꯄꯨꯈꯤ
পুখিবা	ꯄꯨꯈꯤꯕꯥ
পুখ্রগা	ꯄꯨꯈꯔ꯭ꯒꯥ
পুখ্রম্বম	ꯄꯨꯈꯔꯝꯕꯝ
পুখ্রি	ꯄꯨꯈꯔꯤ
পুখ্রিদা	ꯄꯨꯈꯔꯤꯗꯥ
পুখ্রে	ꯄꯨꯈꯔꯦ
পুখৎকদবনি	ꯄꯨꯈꯠꯀꯗꯕꯅꯤ
পুখৎকনি	ꯄꯨꯈꯠꯀꯅꯤ
পুখৎখি	ꯄꯨꯈꯠꯈꯤ
পুখৎখ্রে	ꯄꯨꯈꯠꯈꯔꯦ
পুখৎতুনা	ꯄꯨꯈꯠꯇꯨꯅꯥ
পুখৎনবা	ꯄꯨꯈꯠꯅꯕꯥ
পুখৎপদা	ꯄꯨꯈꯠꯄꯗꯥ
পুখৎপা	ꯄꯨꯈꯠꯄꯥ
পুখৎলকখি	ꯄꯨꯈꯠꯂꯛꯈꯤ
পুখৎলকখিবনি	ꯄꯨꯈꯠꯂꯛꯈꯤꯕꯅꯤ
পুখৎলকপদা	ꯄꯨꯈꯠꯂꯛꯄꯗꯥ
পুখৎলকপা	ꯄꯨꯈꯠꯂꯛꯄꯥ
পুখৎলক্নবা	ꯄꯨꯈꯠꯂꯛꯅꯕꯥ
পুখৎলক্লবা	ꯄꯨꯈꯠꯂꯛꯂꯕꯥ
পুখৎলক্লিবা	ꯄꯨꯈꯠꯂꯛꯂꯤꯕꯥ
পুখৎলদুনা	ꯄꯨꯈꯠꯂꯗꯨꯅꯥ
পুখৎলবা	ꯄꯨꯈꯠꯂꯕꯥ
পুগদবনি	ꯄꯨꯒꯗꯕꯅꯤ
পুগদবা	ꯄꯨꯒꯗꯕꯥ
পুগনি	ꯄꯨꯒꯅꯤ
পুগী	ꯄꯨꯒꯤ
পুগে	ꯄꯨꯒꯦ
পুজা	ꯄꯨꯖꯥ
পুজানচিংবা	ꯄꯨꯖꯥꯅꯆꯤꯡꯕꯥ
পুটতা	ꯄꯨꯇꯇꯥ
পুথবা	ꯄꯨꯊꯕꯥ
পুদনা	ꯄꯨꯗꯅꯥ
পুদুচেরি	ꯄꯨꯗꯨꯆꯦꯔꯤ
পুদুনা	ꯄꯨꯗꯨꯅꯥ
পুনখি	ꯄꯨꯅꯈꯤ
পুনখিবা	ꯄꯨꯅꯈꯤꯕꯥ
পুনগদবা	ꯄꯨꯅꯒꯗꯕꯥ
পুনদুনা	ꯄꯨꯅꯗꯨꯅꯥ
পুননবা	ꯄꯨꯅꯅꯕꯥ
পুনবগী	ꯄꯨꯅꯕꯒꯤ
পুনবসু	ꯄꯨꯅꯕꯁꯨ
পুনবা	ꯄꯨꯅꯕꯥ
পুনম	ꯄꯨꯅꯝ
পুনশিনখি	ꯄꯨꯟꯁꯤꯟꯈꯤ
পুনশিনবনা	ꯄꯨꯟꯁꯤꯟꯕꯅꯥ
পুনশিনবা	ꯄꯨꯟꯁꯤꯟꯕꯥ
পুনশিন্দুনা	ꯄꯨꯟꯁꯤꯟꯗꯨꯅꯥ
পুনশিন্নবা	ꯄꯨꯟꯁꯤꯟꯅꯕꯥ
পুনশিল্লগা	ꯄꯨꯟꯁꯤꯜꯂꯒꯥ
পুনশিল্লি	ꯄꯨꯟꯁꯤꯜꯂꯤ
পুনিয়া	ꯄꯨꯅꯤꯌꯥ
পুনে	ꯄꯨꯅꯦ
পুনেগী	ꯄꯨꯅꯦꯒꯤ
পুনেদা	ꯄꯨꯅꯦꯗꯥ
পুন্দনবা	ꯄꯨꯟꯗꯅꯕꯥ
পুন্দবা	ꯄꯨꯟꯗꯕꯥ
পুন্দুনা	ꯄꯨꯟꯗꯨꯅꯥ
পুন্না	ꯄꯨꯟꯅꯥ
পুন্সি	ꯄꯨꯟꯁꯤ
পুন্সিগা	ꯄꯨꯟꯁꯤꯒꯥ
পুন্সিগী	ꯄꯨꯟꯁꯤꯒꯤ
পুন্সিগীদমক	ꯄꯨꯟꯁꯤꯒꯤꯗꯃꯛ
পুন্সিদসু	ꯄꯨꯟꯁꯤꯗꯁꯨ
পুন্সিদা	ꯄꯨꯟꯁꯤꯗꯥ
পুন্সিবু	ꯄꯨꯟꯁꯤꯕꯨ
পুন্সিসু	ꯄꯨꯟꯁꯤꯁꯨ
পুবগী	ꯄꯨꯕꯒꯤ
পুবদা	ꯄꯨꯕꯗꯥ
পুবনি	ꯄꯨꯕꯅꯤ
পুবশিং	ꯄꯨꯕꯁꯤꯡ
পুবা	ꯄꯨꯕꯥ
পুমচাই	ꯄꯨꯝꯆꯥꯏ
পুমতাক	ꯄꯨꯝꯇꯥꯛ
পুমথিং	ꯄꯨꯝꯊꯤꯡ
পুম্নমক	ꯄꯨꯝꯅꯃꯛ
পুম্নমকপু	ꯄꯨꯝꯅꯃꯛꯄꯨ
পুম্নমক্কা	ꯄꯨꯝꯅꯃꯛꯀꯥ
পুম্নমক্কী	ꯄꯨꯝꯅꯃꯛꯀꯤ
পুম্নমক্না	ꯄꯨꯝꯅꯃꯛꯅꯥ
পুম্বগী	ꯄꯨꯝꯕꯒꯤ
পুম্বদা	ꯄꯨꯝꯕꯗꯥ
পুম্বনা	ꯄꯨꯝꯕꯅꯥ
পুম্বসি	ꯄꯨꯝꯕꯁꯤ
পুম্বা	ꯄꯨꯝꯕꯥ
পুম্মম	ꯄꯨꯝꯃꯝ
পুরকখি	ꯄꯨꯔꯛꯈꯤ
পুরকখিবগা	ꯄꯨꯔꯛꯈꯤꯕꯒꯥ
পুরকখিবনি	ꯄꯨꯔꯛꯈꯤꯕꯅꯤ
পুরকখিবা	ꯄꯨꯔꯛꯈꯤꯕꯥ
পুরকখ্রবা	ꯄꯨꯔꯛꯈꯔ꯭ꯕꯥ
পুরকখ্রে	ꯄꯨꯔꯛꯈꯔꯦ
পুরকপগী	ꯄꯨꯔꯛꯄꯒꯤ
পুরকপদগী	ꯄꯨꯔꯛꯄꯗꯒꯤ
পুরকপদা	ꯄꯨꯔꯛꯄꯗꯥ
পুরকপদি	ꯄꯨꯔꯛꯄꯗꯤ
পুরকপনি	ꯄꯨꯔꯛꯄꯅꯤ
পুরকপা	ꯄꯨꯔꯛꯄꯥ
পুরক্কদবনি	ꯄꯨꯔꯛꯀꯗꯕꯅꯤ
পুরক্কদবা	ꯄꯨꯔꯛꯀꯗꯕꯥ
পুরক্কনি	ꯄꯨꯔꯛꯀꯅꯤ
পুরক্কে	ꯄꯨꯔꯛꯀꯦ
পুরক্নবগী	ꯄꯨꯔꯛꯅꯕꯒꯤ
পুরক্নবগীদমক	ꯄꯨꯔꯛꯅꯕꯒꯤꯗꯃꯛ
পুরক্নবা	ꯄꯨꯔꯛꯅꯕꯥ
পুরক্লগনি	ꯄꯨꯔꯛꯂꯒꯅꯤ
পুরক্লগা	ꯄꯨꯔꯛꯂꯒꯥ
পুরক্লবা	ꯄꯨꯔꯛꯂꯕꯥ
পুরক্লি	ꯄꯨꯔꯛꯂꯤ
পুরক্লিবা	ꯄꯨꯔꯛꯂꯤꯕꯥ
পুরক্লে	ꯄꯨꯔꯛꯂꯦ
পুরগনি	ꯄꯨꯔꯒꯅꯤ
পুরগা	ꯄꯨꯔꯒꯥ
পুরদুনা	ꯄꯨꯔꯗꯨꯅꯥ
পুরনা	ꯄꯨꯔꯅꯥ
পুরবা	ꯄꯨꯔꯕꯥ
পুরম্বা	ꯄꯨꯔꯝꯕꯥ
পুরম্মী	ꯄꯨꯔꯝꯃꯤ
পুরস্কার	ꯄꯨꯔꯁꯀꯥꯔ
পুরি	ꯄꯨꯔꯤ
পুরিনা	ꯄꯨꯔꯤꯅꯥ
পুরিবা	ꯄꯨꯔꯤꯕꯥ
পুরুস্কার	ꯄꯨꯔꯨꯁꯀꯥꯔ
পুরেল	ꯄꯨꯔꯦꯜ
পুরেলদা	ꯄꯨꯔꯦꯜꯗꯥ
পুর্নিমা	ꯄꯨꯔꯅꯤꯃꯥ
পুল	ꯄꯨꯜ
পুলহন্দনবগী	ꯄꯨꯜꯍꯟꯗꯅꯕꯒꯤ
পুলিস	ꯄꯨꯂꯤꯁ
পুলিসকা	ꯄꯨꯂꯤꯁꯀꯥ
পুলিসকি	ꯄꯨꯂꯤꯁꯀꯤ
পুলিসকী	ꯄꯨꯂꯤꯁꯀꯤ
পুলিসতা	ꯄꯨꯂꯤꯁꯇꯥ
পুলিসনসু	ꯄꯨꯂꯤꯁꯟꯁꯨ
পুলিসনা	ꯄꯨꯂꯤꯁꯅꯥ
পুলিসপু	ꯄꯨꯂꯤꯁꯄꯨ
পুলিসশিং	ꯄꯨꯂꯤꯁꯁꯤꯡ
পুলিসশিংনা	ꯄꯨꯂꯤꯁꯁꯤꯡꯅꯥ
পুল্লগা	ꯄꯨꯜꯂꯒꯥ
পুল্লপ	ꯄꯨꯜꯂꯞ
পুলৱামা	ꯄꯨꯂꯋꯥꯃꯥ
পুশিন	ꯄꯨꯁꯤꯟ
পুশিনগী	ꯄꯨꯁꯤꯟꯒꯤ
পুশিনবা	ꯄꯨꯁꯤꯟꯕꯥ
পুশিন্দুনা	ꯄꯨꯁꯤꯟꯗꯨꯅꯥ
পুশিন্নবা	ꯄꯨꯁꯤꯟꯅꯕꯥ
পুশিল্লকই	ꯄꯨꯁꯤꯜꯂꯛꯏ
পুশিল্লকখি	ꯄꯨꯁꯤꯜꯂꯛꯈꯤ
পুশিল্লকপগী	ꯄꯨꯁꯤꯜꯂꯛꯄꯒꯤ
পুশিল্লকপদা	ꯄꯨꯁꯤꯜꯂꯛꯄꯗꯥ
পুশিল্লকপা	ꯄꯨꯁꯤꯜꯂꯛꯄꯥ
পুশিল্লক্নবা	ꯄꯨꯁꯤꯜꯂꯛꯅꯕꯥ
পুশিল্লক্লগা	ꯄꯨꯁꯤꯜꯂꯛꯂꯒꯥ
পুশিল্লক্লবা	ꯄꯨꯁꯤꯜꯂꯛꯂꯕꯥ
পুশিল্লক্লিবা	ꯄꯨꯁꯤꯜꯂꯛꯂꯤꯕꯥ
পুশিল্লগা	ꯄꯨꯁꯤꯜꯂꯒꯥ
পুসিল	ꯄꯨꯁꯤꯂ
পুস্কর	ꯄꯨꯁꯀ꯭ꯔ
পুয়া	ꯄꯨꯌꯥ
পুৱারিগা	ꯄꯨꯋꯥꯔꯤꯒꯥ
পুৱারী	ꯄꯨꯋꯥꯔꯤ
পুৱারীদা	ꯄꯨꯋꯥꯔꯤꯗꯥ
পূক্নিং	ꯄꯨꯛꯅꯤꯪ
পূখ্রি	ꯄꯨꯈꯔꯤ
পূজা	ꯄꯨꯖꯥ
পূন্দুনা	ꯄꯨꯟꯗꯨꯅꯥ
পূন্না	ꯄꯨꯟꯅꯥ
পূম্নমক	ꯄꯨꯝꯅꯃꯛ
পূম্নমক্কী	ꯄꯨꯝꯅꯃꯛꯀꯤ
পূম্নমক্না	ꯄꯨꯝꯅꯃꯛꯅꯥ
পূম্বা	ꯄꯨꯝꯕꯥ
পৃথিবা	ꯄꯔ꯭ꯊꯤꯕꯥ
পৃথিবী	ꯄꯔ꯭ꯊꯤꯕꯤ
পৃথিবীগী	ꯄꯔ꯭ꯊꯤꯕꯤꯒꯤ
পৃথিবীদা	ꯄꯔ꯭ꯊꯤꯕꯤꯗꯥ
পে	ꯄꯦ
পেংবা	ꯄꯦꯡꯕꯥ
পেকেজ	ꯄꯦꯀꯦꯖ
পেকেজিং	ꯄꯦꯀꯦꯖꯤꯡ
পেকেজিংগী	ꯄꯦꯀꯦꯖꯤꯡꯒꯤ
পেচি	ꯄꯦꯆꯤ
পেজ	ꯄꯦꯖ
পেদ	ꯄꯦꯗ
পেন	ꯄꯦꯅ
পেনগা	ꯄꯦꯟꯒꯥ
পেনা	ꯄꯦꯅꯥ
পেনালটি	ꯄꯦꯅꯥꯜꯇꯤ
পেনিক	ꯄꯦꯅꯤꯛ
পেনেল	ꯄꯦꯅꯦꯜ
পেনেলশিং	ꯄꯦꯅꯦꯜꯁꯤꯡ
পেন্টর	ꯄꯦꯟꯇꯔ
পেন্টিং	ꯄꯦꯟꯇꯤꯡ
পেন্দবা	ꯄꯦꯟꯗꯕꯥ
পেন্দামিক	ꯄꯦꯟꯗꯥꯃꯤꯛ
পেন্না	ꯄꯦꯟꯅꯥ
পেন্নিংঙাই	ꯄꯦꯟꯅꯤꯡꯉꯥꯏ
পেন্সন	ꯄꯦꯟꯁꯟ
পেন্সনগী	ꯄꯦꯟꯁꯟꯒꯤ
পেন্সননা	ꯄꯦꯟꯁꯟꯅꯥ
পেন্সনর	ꯄꯦꯟꯁꯟꯔ
পেন্সন্নচিংবা	ꯄꯦꯟꯁꯟꯅꯆꯤꯡꯕꯥ
পেপর	ꯄꯦꯄꯔ
পেপরশিং	ꯄꯦꯄꯔꯁꯤꯡ
পেবম	ꯄꯦꯕꯝ
পেমেন্ট	ꯄꯦꯃꯦꯟꯇ
পেরা	ꯄꯦꯔꯥ
পেরামিটর	ꯄꯦꯔꯥꯃꯤꯇꯔ
পেরিস	ꯄꯦꯔꯤꯁ
পেরিসকী	ꯄꯦꯔꯤꯁꯀꯤ
পেরিসতা	ꯄꯦꯔꯤꯁꯇꯥ
পেরেদ	ꯄꯦꯔꯦꯗ
পেরেদকী	ꯄꯦꯔꯦꯗꯀꯤ
পেরেন্ট	ꯄꯦꯔꯦꯟꯇ
পেরেল	ꯄꯦꯔꯦꯂ
পেলেস	ꯄꯦꯂꯦꯁ
পেল্লদুনা	ꯄꯦꯜꯂꯗꯨꯅꯥ
পেল্লবা	ꯄꯦꯜꯂꯕꯥ
পেল্লে	ꯄꯦꯜꯂꯦ
পেসিফিক	ꯄꯦꯁꯤꯐꯤꯛ
পেসেঞ্জর	ꯄꯦꯁꯦꯟꯖꯔ
পেসেঞ্জরশিং	ꯄꯦꯁꯦꯟꯖꯔꯁꯤꯡ
পেসেঞ্জরশিংগী	ꯄꯦꯁꯦꯟꯖꯔꯁꯤꯡꯒꯤ
পেসেঞ্জরশিংদা	ꯄꯦꯁꯦꯟꯖꯔꯁꯤꯡꯗꯥ
পেসেঞ্জরশিংনা	ꯄꯦꯁꯦꯟꯖꯔꯁꯤꯡꯅꯥ
পেসেন্ট	ꯄꯦꯁꯦꯟꯇ
পেসেন্টকী	ꯄꯦꯁꯦꯟꯇꯀꯤ
পেসেন্টশিং	ꯄꯦꯁꯦꯟꯇꯁꯤꯡ
পেসেন্টশিংগী	ꯄꯦꯁꯦꯟꯇꯁꯤꯡꯒꯤ
পেসেন্টশিংগীদমক	ꯄꯦꯁꯦꯟꯇꯁꯤꯡꯒꯤꯗꯃꯛ
পৈদুনা	ꯄꯩꯗꯨꯅꯥ
পৈশা	ꯄꯩꯁꯥ
পৈশিন্দুনা	ꯄꯩꯁꯤꯟꯗꯨꯅꯥ
প্রকাশ	ꯄꯔ꯭ꯀꯥꯁ
প্রকৃতিগা	ꯄꯔꯀ꯭ꯔꯤꯇꯤꯒꯥ
প্রকৃতিনা	ꯄꯔꯀ꯭ꯔꯤꯇꯤꯅꯥ
প্রজা	ꯄꯔ꯭ꯖꯥ
প্রজাশিং	ꯄꯔ꯭ꯖꯥꯁꯤꯪ
প্রজাশিংগী	ꯄꯔ꯭ꯖꯥꯁꯤꯡꯒꯤ
প্রজাশিংদি	ꯄꯔ꯭ꯖꯥꯁꯤꯪꯗꯤ
প্রজাশিংনা	ꯄꯔ꯭ꯖꯥꯁꯤꯪꯅꯥ
প্রজেন্ট	ꯄꯔ꯭ꯖꯦꯟꯇ
প্রজেন্টেসন	ꯄꯔ꯭ꯖꯦꯟꯇꯦꯁꯟ
প্রতাপ	ꯄꯔ꯭ꯇꯥꯄ
প্রতিভা	ꯄꯔ꯭ꯇꯤꯚꯥ
প্রদক্টশিং	ꯄꯔ꯭ꯗꯛꯇꯁꯤꯡ
প্রদক্সন	ꯄꯔ꯭ꯗꯛꯁꯟ
প্রদক্সনগী	ꯄꯔ꯭ꯗꯛꯁꯟꯒꯤ
প্রদিপ	ꯄꯔ꯭ꯗꯤꯄ
প্রদেশ	ꯄꯔ꯭ꯗꯦꯁ
প্রদেশকি	ꯄꯔ꯭ꯗꯦꯁꯀꯤ
প্রদেশকী	ꯄꯔ꯭ꯗꯦꯁꯀꯤ
প্রদেশতসু	ꯄꯔ꯭ꯗꯦꯁꯇꯁꯨ
প্রদেশতা	ꯄꯔ꯭ꯗꯦꯁꯇꯥ
প্রদেশনা	ꯄꯔ꯭ꯗꯦꯁꯅꯥ
প্রদেশনি	ꯄꯔ꯭ꯗꯦꯁꯅꯤ
প্রদেশসু	ꯄꯔ꯭ꯗꯦꯁꯁꯨ
প্রদেস	ꯄꯔ꯭ꯗꯦꯁ
প্রদেসকী	ꯄꯔ꯭ꯗꯦꯁꯀꯤ
প্রদেসতা	ꯄꯔ꯭ꯗꯦꯁꯇꯥ
প্রদেসনা	ꯄꯔ꯭ꯗꯦꯁꯅꯥ
প্রধান	ꯄꯔ꯭ꯙꯥꯅ
প্রধাননা	ꯄꯔ꯭ꯙꯥꯅꯅꯥ
প্রনাব	ꯄꯔ꯭ꯅꯥꯕ
প্রবিন	ꯄꯔ꯭ꯕꯤꯟ
প্রবিননা	ꯄꯔ꯭ꯕꯤꯟꯅꯥ
প্রভু	ꯄꯔ꯭ꯚꯨ
প্রভেশ	ꯄꯔ꯭ꯚꯦꯁ
প্রমান	ꯄꯔ꯭ꯃꯥꯟ
প্রমেশ্বরনা	ꯄꯔ꯭ꯃꯦꯁꯋ꯭ꯔꯅꯥ
প্রসাদ	ꯄꯔ꯭ꯁꯥꯗ
প্রসাদকী	ꯄꯔ꯭ꯁꯥꯗꯀꯤ
প্রসাদনা	ꯄꯔ꯭ꯁꯥꯗꯅꯥ
প্রসার	ꯄꯔ꯭ꯁꯥꯔ
প্রসিদেন্ট	ꯄꯔ꯭ꯁꯤꯗꯦꯟꯇ
প্রসিদেন্টকা	ꯄꯔ꯭ꯁꯤꯗꯦꯟꯇꯀꯥ
প্রসিদেন্টকী	ꯄꯔ꯭ꯁꯤꯗꯦꯟꯇꯀꯤ
প্রসিদেন্টনা	ꯄꯔ꯭ꯁꯤꯗꯦꯟꯇꯅꯥ
প্রসিদেন্টপু	ꯄꯔ꯭ꯁꯤꯗꯦꯟꯇꯄꯨ
প্রসিদেন্টসু	ꯄꯔ꯭ꯁꯤꯗꯦꯟꯇꯁꯨ
প্রসিদেন্সি	ꯄꯔ꯭ꯁꯤꯗꯦꯟꯁꯤ
প্রসিন্টে	ꯄꯔ꯭ꯁꯤꯟꯇꯦ
প্রাইজ	ꯄꯔꯥꯏꯖ
প্রাইদ	ꯄꯔꯥꯏꯗ
প্রাইবেট	ꯄꯔꯥꯏꯕꯦꯇ
প্রাইভেট	ꯞꯔꯥꯏꯚꯦꯇ
প্রাইম	ꯞꯔꯥꯏꯝ
প্রাইমারি	ꯞꯔꯥꯏꯃꯥꯔꯤ
প্রাক্টিস	ꯞꯔꯥꯛꯇꯤꯁ
প্রি	ꯄ꯭ꯔꯤ
প্রিজার্বেসন	ꯄ꯭ꯔꯤꯖꯥꯔꯕꯦꯁꯟ
প্রিন্ট	ꯄ꯭ꯔꯤꯟꯠ
প্রিন্স	ꯄ꯭ꯔꯤꯟꯁ
প্রিন্সিপল	ꯄ꯭ꯔꯤꯟꯁꯤꯄꯜ
প্রিন্সিপাল	ꯄ꯭ꯔꯤꯟꯁꯤꯄꯥꯜ
প্রিন্সিপালগী	ꯄ꯭ꯔꯤꯟꯁꯤꯄꯥꯜꯒꯤ
প্রিফরেন্স	ꯄ꯭ꯔꯤꯐꯔꯦꯟꯁ
প্রিভেন্সন	ꯄ꯭ꯔꯤꯚꯦꯟꯁꯟ
প্রিসাইদ	ꯞꯔꯤꯁꯥꯏꯗ
প্রিয়া	ꯄ꯭ꯔꯤꯌꯥ
প্রিয়াঙ্কা	ꯄ꯭ꯔꯤꯌꯥꯡꯀꯥ
প্রেম	ꯄ꯭ꯔꯦꯝ
প্রেমকুমার	ꯄ꯭ꯔꯦꯝꯀꯨꯃꯥꯔ
প্রেমচান্দগী	ꯄ꯭ꯔꯦꯝꯆꯥꯟꯗꯒꯤ
প্রেমানন্দ	ꯄ꯭ꯔꯦꯃꯥꯅꯟꯗ
প্রেমি	ꯄ꯭ꯔꯦꯃꯤ
প্রেমিলা	ꯄ꯭ꯔꯦꯃꯤꯂꯥ
প্রেমিয়র	ꯄ꯭ꯔꯦꯃꯤꯌꯔ
প্রেস	ꯄ꯭ꯔꯦꯁ
প্রেসকী	ꯄ꯭ꯔꯦꯁꯀꯤ
প্রেসতা	ꯄ꯭ꯔꯦꯁꯇ
প্রেসর	ꯄ꯭ꯔꯦꯁꯔ
প্রেস্ক্রাইব	ꯄ꯭ꯔꯦꯁꯀ꯭ꯔꯥꯏꯕ
প্লস	ꯄꯂ꯭ꯁ
প্লান	ꯄ꯭ꯂꯥꯟ
প্লানিং	ꯄ꯭ꯂꯥꯅꯤꯡ
প্লানেট	ꯄ꯭ꯂꯥꯅꯦꯠ
প্লান্ট	ꯄ꯭ꯂꯥꯟꯠ
প্লান্টতা	ꯄ꯭ꯂꯥꯟꯇꯇ
প্লান্টেসন	ꯄ꯭ꯂꯥꯟꯇꯦꯁꯟ
প্লান্নিং	ꯄ꯭ꯂꯥꯟꯅꯤꯡ
প্লাষ্টিক	ꯄ꯭ꯂꯥꯁꯇꯤꯛ
প্লাষ্টিক্কী	ꯄ꯭ꯂꯥꯁꯇꯤꯛꯀꯤ
প্লে	ꯄ꯭ꯂꯦ
প্লেকার্দ	ꯄ꯭ꯂꯦꯀꯥꯔꯗ
প্লেগ	ꯄ꯭ꯂꯦꯒ
প্লেট	ꯄ꯭ꯂꯦꯠ
প্লেদা	ꯄ꯭ꯂꯦꯗ
প্লেন	ꯄ꯭ꯂꯦꯟ
প্লেননা	ꯄ꯭ꯂꯦꯟꯅ
প্লেস	ꯄ꯭ꯂꯦꯁ
প্লেয়র	ꯄ꯭ꯂꯦꯌꯔ
প্লেয়ার	ꯄ꯭ꯂꯦꯌꯥꯔ
পৎ	ꯄꯠ
পয়া	ꯄꯌꯥ
পৱার	ꯄꯋꯥꯔ
পৱারগী	ꯄꯋꯥꯔꯒꯤ
ফ	ꯐ
ফং	ꯐꯪ
ফংই	ꯐꯪꯏ
ফংখি	ꯐꯪꯈꯤ
ফংখিগনি	ꯐꯪꯈꯤꯒꯅꯤ
ফংখিদে	ꯐꯪꯈꯤꯗꯦ
ফংখিদ্রে	ꯐꯪꯈꯤꯗꯔꯦ
ফংখিবগা	ꯐꯪꯈꯤꯕꯒ
ফংখিবগী	ꯐꯪꯈꯤꯕꯒꯤ
ফংখিবনি	ꯐꯪꯈꯤꯕꯅꯤ
ফংখিবশিং	ꯐꯪꯈꯤꯕꯁꯤꯡ
ফংখিবা	ꯐꯪꯈꯤꯕ
ফংখ্রবনি	ꯐꯪꯈꯔ꯭ꯕꯅꯤ
ফংখ্রবসু	ꯐꯪꯈꯔ꯭ꯕꯁꯨ
ফংখ্রবা	ꯐꯪꯈ꯭ꯔꯕ
ফংখ্রবী	ꯐꯪꯈ꯭ꯔꯕꯤ
ফংখ্রে	ꯐꯪꯈꯔꯦ
ফংগদবা	ꯐꯪꯒꯗꯕ
ফংগনি	ꯐꯪꯒꯅꯤ
ফংজখি	ꯐꯪꯖꯈꯤ
ফংজনবা	ꯐꯪꯖꯟꯕ
ফংজবা	ꯐꯪꯖꯕ
ফংজরে	ꯐꯪꯖꯔꯦ
ফংজৈ	ꯐꯪꯖꯩ
ফংদদুনা	ꯐꯪꯗꯗꯨꯅ
ফংদনা	ꯐꯪꯗꯅ
ফংদবগী	ꯐꯪꯗꯕꯒꯤ
ফংদবদগী	ꯐꯪꯗꯕꯗꯒꯤ
ফংদবনা	ꯐꯪꯗꯕꯅ
ফংদবসিনা	ꯐꯪꯗꯕꯁꯤꯅꯥ
ফংদবা	ꯐꯪꯗꯕ
ফংদুনা	ꯐꯪꯗꯨꯅ
ফংদে	ꯐꯪꯗꯦ
ফংদ্রবদা	ꯐꯪꯗꯔ꯭ꯕꯗꯥ
ফংদ্রবদি	ꯐꯪꯗ꯭ꯔꯕꯗꯤ
ফংদ্রবসু	ꯐꯪꯗ꯭ꯔꯕꯁꯨ
ফংদ্রবা	ꯐꯪꯗ꯭ꯔꯕ
ফংদ্রি	ꯐꯪꯗꯔꯤ
ফংদ্রিবা	ꯐꯪꯗꯔꯤꯕ
ফংদ্রে	ꯐꯪꯗꯔꯦ
ফংনদবগী	ꯐꯪꯅꯗꯕꯒꯤ
ফংননবগীদমক	ꯐꯪꯅꯅꯕꯒꯤꯗꯃꯛ
ফংননবা	ꯐꯪꯅꯅꯕ
ফংনবগী	ꯐꯪꯅꯕꯒꯤ
ফংনবগীদমক	ꯐꯪꯅꯕꯒꯤꯗꯃꯛ
ফংনবা	ꯐꯪꯅꯕ
ফংনা	ꯐꯪꯅꯥ
ফংফম	ꯐꯪꯐꯝ
ফংবগা	ꯐꯪꯕꯒ
ফংবগী	ꯐꯪꯕꯒꯤ
ফংবগীদমক	ꯐꯪꯕꯒꯤꯗꯃꯛ
ফংবগে	ꯐꯪꯕꯒꯦ
ফংবতা	ꯐꯪꯕꯇ
ফংবদগী	ꯐꯪꯕꯗꯒꯤ
ফংবদা	ꯐꯪꯕꯗ
ফংবদি	ꯐꯪꯕꯗꯤ
ফংবনা	ꯐꯪꯕꯅ
ফংবনি	ꯐꯪꯕꯅꯤ
ফংবসু	ꯐꯪꯕꯁꯨ
ফংবা	ꯐꯪꯕꯥ
ফংলকখি	ꯐꯪꯂꯛꯈꯤ
ফংলকখিবা	ꯐꯪꯂꯛꯈꯤꯕ
ফংলকখ্রবা	ꯐꯪꯂꯛꯈ꯭ꯔꯕ
ফংলকখ্রবী	ꯐꯪꯂꯛꯈ꯭ꯔꯕꯤ
ফংলকপগা	ꯐꯪꯂꯛꯄꯒ
ফংলকপদগী	ꯐꯪꯂꯛꯄꯗꯒꯤ
ফংলকপা	ꯐꯪꯂꯛꯄ
ফংলক্লে	ꯐꯪꯂꯛꯂꯦ
ফংলগনি	ꯐꯪꯂꯒꯅꯤ
ফংলগা	ꯐꯪꯂꯒ
ফংলদুনা	ꯐꯪꯂꯗꯨꯅꯥ
ফংলনি	ꯐꯪꯂꯅꯤ
ফংলবদি	ꯐꯪꯂꯕꯗꯤ
ফংলবনি	ꯐꯪꯂꯕꯅꯤ
ফংলবা	ꯐꯪꯂꯕ
ফংলবী	ꯐꯪꯂꯕꯤ
ফংলম্বা	ꯐꯪꯂꯝꯕ
ফংলম্মী	ꯐꯪꯂꯝꯃꯤ
ফংলি	ꯐꯪꯂꯤ
ফংলিঙৈ	ꯐꯪꯂꯤꯉꯩ
ফংলিবনি	ꯐꯪꯂꯤꯕꯅꯤ
ফংলিবা	ꯐꯪꯂꯤꯕ
ফংলিব্রা	ꯐꯪꯂꯤꯕꯔꯥ
ফংলে	ꯐꯪꯂꯦ
ফংহনখি	ꯐꯪꯍꯟꯈꯤ
ফংহনখিবা	ꯐꯪꯍꯟꯈꯤꯕ
ফংহনখ্রবনি	ꯐꯪꯍꯟꯈ꯭ꯔꯕꯅꯤ
ফংহনখ্রে	ꯐꯪꯍꯟꯈꯔꯦ
ফংহনগদবনি	ꯐꯪꯍꯟꯒꯗꯕꯅꯤ
ফংহনগদবা	ꯐꯪꯍꯟꯒꯗꯕ
ফংহনগনি	ꯐꯪꯍꯟꯒꯅꯤ
ফংহনবগা	ꯐꯪꯍꯟꯕꯒ
ফংহনবগী	ꯐꯪꯍꯟꯕꯒꯤ
ফংহনবদা	ꯐꯪꯍꯟꯕꯗ
ফংহনবনা	ꯐꯪꯍꯟꯕꯅ
ফংহনবনি	ꯐꯪꯍꯟꯕꯅꯤ
ফংহনবা	ꯐꯪꯍꯟꯕ
ফংহন্দবা	ꯐꯪꯍꯟꯗꯕꯥ
ফংহন্দুনা	ꯐꯪꯍꯟꯗꯨꯅ
ফংহন্নবগী	ꯐꯪꯍꯟꯅꯕꯒꯤ
ফংহন্নবসু	ꯐꯪꯍꯟꯅꯕꯁꯨ
ফংহন্নবা	ꯐꯪꯍꯟꯅꯕ
ফংহল্লগনি	ꯐꯪꯍꯜꯂꯒꯅꯤ
ফংহল্লম্বা	ꯐꯪꯍꯜꯂꯝꯕ
ফংহল্লি	ꯐꯪꯍꯜꯂꯤ
ফংহল্লিবা	ꯐꯪꯍꯜꯂꯤꯕ
ফংহল্লু	ꯐꯪꯍꯜꯂꯨ
ফংহল্লে	ꯐꯪꯍꯜꯂꯦ
ফক	ꯐꯛ
ফক্লাংদা	ꯐꯛꯂꯥꯪꯗꯥ
ফখিবগা	ꯐꯈꯤꯕꯒ
ফখিবগী	ꯐꯈꯤꯕꯒꯤ
ফখিবনা	ꯐꯈꯤꯕꯅ
ফখিবা	ꯐꯈꯤꯕ
ফখ্রবা	ꯐꯈ꯭ꯔꯕ
ফখ্রে	ꯐꯈꯔꯦ
ফগনি	ꯐꯒꯅꯤ
ফগৎকনি	ꯐꯒꯠꯀꯅꯤ
ফগৎখিবা	ꯐꯒꯠꯈꯤꯕ
ফগৎনবা	ꯐꯒꯠꯅꯕ
ফগৎপগা	ꯐꯒꯠꯄꯒ
ফগৎপগী	ꯐꯒꯠꯄꯒꯤ
ফগৎপনা	ꯐꯒꯠꯄꯅ
ফগৎপা	ꯐꯒꯠꯄ
ফগৎলকখি	ꯐꯒꯠꯂꯛꯈꯤ
ফগৎলকখিবগা	ꯐꯒꯠꯂꯛꯈꯤꯕꯒ
ফগৎলকখিবা	ꯐꯒꯠꯂꯛꯈꯤꯕ
ফগৎলকখ্রে	ꯐꯒꯠꯂꯛꯈꯔꯦ
ফগৎলকপগা	ꯐꯒꯠꯂꯛꯄꯒ
ফগৎলকপগী	ꯐꯒꯠꯂꯛꯄꯒꯤ
ফগৎলকপদগী	ꯐꯒꯠꯂꯛꯄꯗꯒꯤ
ফগৎলকপনা	ꯐꯒꯠꯂꯛꯄꯅ
ফগৎলকপা	ꯐꯒꯠꯂꯛꯄ
ফগৎলক্কনি	ꯐꯒꯠꯂꯛꯀꯅꯤ
ফগৎলক্নবা	ꯐꯒꯠꯂꯛꯅꯕ
ফগৎলক্লগনি	ꯐꯒꯠꯂꯛꯂꯒꯅꯤ
ফগৎলক্লি	ꯐꯒꯠꯂꯛꯂꯤ
ফগৎলক্লে	ꯐꯒꯠꯂꯛꯂꯦ
ফগৎলব্রা	ꯐꯒꯠꯂꯕꯔꯥ
ফগৎলে	ꯐꯒꯠꯂꯦ
ফগৎহনগদবা	ꯐꯒꯠꯍꯟꯒꯗꯕ
ফগৎহনবনি	ꯐꯒꯠꯍꯟꯕꯅꯤ
ফগৎহনবা	ꯐꯒꯠꯍꯟꯕ
ফগৎহন্নবগী	ꯐꯒꯠꯍꯟꯅꯕꯒꯤ
ফগৎহন্নবা	ꯐꯒꯠꯍꯟꯅꯕ
ফঙ্কসন	ꯐꯪꯛꯁꯟ
ফঙ্কসনেল	ꯐꯪꯛꯁꯅꯦꯜ
ফজ	ꯐꯖ
ফজখ্রবা	ꯐꯖꯈꯔ꯭ꯕꯥ
ফজখ্রে	ꯐꯖꯈꯔꯦ
ফজদবা	ꯐꯖꯗꯕ
ফজনদি	ꯐꯖꯟꯗꯤ
ফজনা	ꯐꯖꯅ
ফজবদা	ꯐꯖꯕꯗꯥ
ফজবা	ꯐꯖꯕ
ফজবী	ꯐꯖꯕꯤ
ফজরবা	ꯐꯖꯔꯕ
ফজা	ꯐꯖꯥ
ফজৈ	ꯐꯖꯩ
ফজৈদা	ꯐꯖꯩꯗꯥ
ফত্ত	ꯐꯠꯇ
ফত্তদুনা	ꯐꯠꯇꯗꯨꯅ
ফত্তনা	ꯐꯠꯇꯅꯥ
ফত্তবগী	ꯐꯠꯇꯕꯒꯤ
ফত্তবদগী	ꯐꯠꯇꯕꯗꯒꯤ
ফত্তবদা	ꯐꯠꯇꯕꯗꯥ
ফত্তবনা	ꯐꯠꯇꯕꯅ
ফত্তববু	ꯐꯠꯇꯕꯕꯨ
ফত্তবশিং	ꯐꯠꯇꯕꯁꯤꯡ
ফত্তবা	ꯐꯠꯇꯕ
ফত্তবী	ꯐꯠꯇꯕꯤ
ফত্তবীগী	ꯐꯠꯇꯕꯤꯒꯤ
ফত্তা	ꯐꯠꯇ
ফত্তে	ꯐꯠꯇꯦ
ফত্ত্রবা	ꯐꯠꯇꯔ꯭ꯕꯥ
ফদনা	ꯐꯗꯅ
ফদবা	ꯐꯗꯕ
ফদুনা	ꯐꯗꯨꯅ
ফন	ꯐꯟ
ফনদুম	ꯐꯟꯗꯨꯃ
ফনবা	ꯐꯟꯕ
ফনা	ꯐꯅ
ফনেক	ꯐꯅꯦꯛ
ফন্দ	ꯐꯟꯗ
ফন্দগী	ꯐꯟꯗꯒꯤ
ফন্দদগী	ꯐꯟꯗꯗꯒꯤ
ফন্দদা	ꯐꯟꯗꯗ
ফন্দশিং	ꯐꯟꯗꯁꯤꯡ
ফন্দশিংগী	ꯐꯟꯗꯁꯤꯡꯒꯤ
ফন্দামেন্টেল	ꯐꯟꯗꯥꯃꯦꯟꯇꯦꯜ
ফন্দিং	ꯐꯟꯗꯤꯡ
ফন্দেদ	ꯐꯟꯗꯦꯗ
ফন্না	ꯐꯟꯅꯥ
ফবগী	ꯐꯕꯒꯤ
ফবদগী	ꯐꯕꯗꯒꯤ
ফবনা	ꯐꯕꯅꯥ
ফবনি	ꯐꯕꯅꯤ
ফবসু	ꯐꯕꯁꯨ
ফবা	ꯐꯕ
ফম	ꯐꯝ
ফমখি	ꯐꯝꯈꯤ
ফমখিবনি	ꯐꯝꯈꯤꯕꯅꯤ
ফমখিবা	ꯐꯝꯈꯤꯕ
ফমগদবনি	ꯐꯝꯒꯗꯕꯅꯤ
ফমগনি	ꯐꯝꯒꯅꯤ
ফমগী	ꯐꯝꯒꯤ
ফমগীদমক	ꯐꯝꯒꯤꯗꯃꯛ
ফমদগী	ꯐꯝꯗꯒꯤ
ফমদুনা	ꯐꯝꯗꯨꯅ
ফমফমদা	ꯐꯝꯐꯝꯗ
ফমশিং	ꯐꯝꯁꯤꯡ
ফমসু	ꯐꯝꯁꯨ
ফমহন্দুনা	ꯐꯝꯍꯟꯗꯨꯅ
ফমিন্নদুনা	ꯐꯃꯤꯟꯅꯗꯨꯅ
ফমুং	ꯐꯃꯨꯡ
ফমুংদা	ꯐꯃꯨꯪꯗꯥ
ফম্নবা	ꯐꯝꯅꯕ
ফম্না	ꯐꯝꯅꯥ
ফম্নাই	ꯐꯝꯅꯥꯏ
ফম্নাইবশিং	ꯐꯝꯅꯥꯏꯕꯁꯤꯪ
ফম্নাইবা	ꯐꯝꯅꯥꯏꯕꯥ
ফম্ফম	ꯐꯝꯐꯝ
ফম্বদা	ꯐꯝꯕꯗꯥ
ফম্বা	ꯐꯝꯕꯥ
ফম্বী	ꯐꯝꯕꯤ
ফম্বীশিংগী	ꯐꯝꯕꯤꯁꯤꯡꯒꯤ
ফম্মিন্নদুনা	ꯐꯝꯃꯤꯟꯅꯗꯨꯅꯥ
ফম্মেন্দা	ꯐꯝꯃꯦꯟꯗꯥ
ফম্লগা	ꯐꯝꯂꯒ
ফম্লম্বা	ꯐꯝꯂꯝꯕꯥ
ফম্লিবা	ꯐꯝꯂꯤꯕꯥ
ফর	ꯐꯔ
ফরকপগী	ꯐꯔꯛꯄꯒꯤ
ফরক্লবা	ꯐꯔꯛꯂꯕ
ফরক্লে	ꯐꯔꯛꯂꯦ
ফরগনি	ꯐꯔꯒꯅꯤ
ফরগা	ꯐꯔꯒꯥ
ফরনি	ꯐꯔꯅꯤ
ফরবদি	ꯐꯔꯕꯗꯤ
ফরবা	ꯐꯔꯕ
ফরবী	ꯐꯔꯕꯤ
ফরি	ꯐꯔꯤ
ফরে	ꯐꯔꯦ
ফল	ꯐꯜ
ফলদা	ꯐꯜꯗꯥ
ফলনা	ꯐꯜꯅꯥ
ফলশিং	ꯐꯜꯁꯤꯡ
ফহনবগী	ꯐꯍꯟꯕꯒꯤ
ফহনবা	ꯐꯍꯟꯕ
ফা	ꯐꯥ
ফাই	ꯐꯥꯏ
ফাইটর	ꯐꯥꯏꯇꯔ
ফাইটরশিং	ꯐꯥꯏꯇꯔꯁꯤꯡ
ফাইটরশিংগী	ꯐꯥꯏꯇꯔꯁꯤꯡꯒꯤ
ফাইটিং	ꯐꯥꯏꯇꯤꯡ
ফাইন	ꯐꯥꯏꯟ
ফাইনগী	ꯐꯥꯏꯟꯒꯤ
ফাইনান্স	ꯐꯥꯏꯅꯥꯟꯁ
ফাইনান্সিয়েল	ꯐꯥꯏꯅꯥꯟꯁꯤꯌꯦꯜ
ফাইনেল	ꯐꯥꯏꯅꯦꯜ
ফাইনেলগী	ꯐꯥꯏꯅꯦꯜꯒꯤ
ফাইনেলগীদমক	ꯐꯥꯏꯅꯦꯜꯒꯤꯗꯃꯛ
ফাইনেলদা	ꯐꯥꯏꯅꯦꯜꯗ
ফাইন্দিং	ꯐꯥꯏꯟꯗꯤꯡ
ফাইব	ꯐꯥꯏꯕ
ফাইভ	ꯐꯥꯏꯚ
ফাইরেন	ꯐꯥꯏꯔꯦꯅ
ফাইল	ꯐꯥꯏꯜ
ফাইলশিং	ꯐꯥꯏꯜꯁꯤꯡ
ফাওই	ꯐꯥꯎꯏ
ফাওগী	ꯐꯥꯎꯒꯤ
ফাওজিন	ꯐꯥꯎꯖꯤꯟ
ফাওদুনা	ꯐꯥꯎꯗꯨꯅ
ফাওনগদবনি	ꯐꯥꯎꯅꯒꯗꯕꯅꯤ
ফাওনদবা	ꯐꯥꯎꯅꯗꯕ
ফাওনদুনা	ꯐꯥꯎꯅꯗꯨꯅ
ফাওনদ্রে	ꯐꯥꯎꯅꯗꯔꯦ
ফাওননবা	ꯐꯥꯎꯅꯅꯕ
ফাওনবগী	ꯐꯥꯎꯅꯕꯒꯤ
ফাওনবদা	ꯐꯥꯎꯅꯕꯗ
ফাওনবা	ꯐꯥꯎꯅꯕ
ফাওনরি	ꯐꯥꯎꯅꯔꯤ
ফাওনরিবা	ꯐꯥꯎꯅꯔꯤꯕ
ফাওনা	ꯐꯥꯎꯅ
ফাওন্দেসন	ꯐꯥꯎꯟꯗꯦꯁꯟ
ফাওবগী	ꯐꯥꯎꯕꯒꯤ
ফাওবগীদি	ꯐꯥꯎꯕꯒꯤꯗꯤ
ফাওবদং	ꯐꯥꯎꯕꯗꯪ
ফাওবদগী	ꯐꯥꯎꯕꯗꯒꯤ
ফাওবদদি	ꯐꯥꯎꯕꯗꯗꯤ
ফাওবদনা	ꯐꯥꯎꯕꯗꯅ
ফাওবদা	ꯐꯥꯎꯕꯗ
ফাওবদি	ꯐꯥꯎꯕꯗꯤ
ফাওবনা	ꯐꯥꯎꯕꯅ
ফাওবনি	ꯐꯥꯎꯕꯅꯤ
ফাওবা	ꯐꯥꯎꯕ
ফাওরকপা	ꯐꯥꯎꯔꯛꯄ
ফাওরক্লে	ꯐꯥꯑꯣꯔꯛꯂꯦ
ফাওরগা	ꯐꯥꯎꯔꯒ
ফাওরিবা	ꯐꯥꯎꯔꯤꯕ
ফাওরে	ꯐꯥꯑꯣꯔꯦ
ফাওরেং	ꯐꯥꯑꯣꯔꯦꯪ
ফাওহনবা	ꯐꯥꯎꯍꯟꯕ
ফাওহল্লি	ꯐꯥꯎꯍꯜꯂꯤ
ফাক	ꯐꯥꯀ
ফাখি	ꯐꯥꯈꯤ
ফাখিবগী	ꯐꯥꯈꯤꯕꯒꯤ
ফাখিবনি	ꯐꯥꯈꯤꯕꯅꯤ
ফাখিবা	ꯐꯥꯈꯤꯕ
ফাখ্রবনি	ꯐꯥꯈ꯭ꯔꯕꯅꯤ
ফাখ্রে	ꯐꯥꯈꯔꯦ
ফাগী	ꯐꯥꯒꯤ
ফাগে	ꯐꯥꯒꯦ
ফাগৎখি	ꯐꯥꯒꯠꯈꯤ
ফাগৎখিবনি	ꯐꯥꯒꯠꯈꯤꯕꯅꯤ
ফাগৎখ্রে	ꯐꯥꯒꯠꯈꯔꯦ
ফাগৎপগা	ꯐꯥꯒꯠꯄꯒ
ফাগৎপগী	ꯐꯥꯒꯠꯄꯒꯤ
ফাগৎপা	ꯐꯥꯒꯠꯄ
ফাগৎলকপনি	ꯐꯥꯒꯠꯂꯛꯄꯅꯤ
ফাগৎলগা	ꯐꯥꯒꯠꯂꯒ
ফাগৎলবা	ꯐꯥꯒꯠꯂꯕ
ফাগৎলে	ꯐꯥꯒꯠꯂꯦ
ফাজিন	ꯐꯥꯖꯤꯅ
ফাজিনখি	ꯐꯥꯖꯤꯟꯈꯤ
ফাজিনখিবা	ꯐꯥꯖꯤꯟꯈꯤꯕ
ফাজিনবা	ꯐꯥꯖꯤꯟꯕ
ফাজিল্লক্লবা	ꯐꯥꯖꯤꯜꯂꯛꯂꯕ
ফাজিল্লক্লে	ꯐꯥꯖꯤꯜꯂꯛꯂꯦ
ফাদবা	ꯐꯥꯗꯕ
ফাদর	ꯐꯥꯗꯔ
ফাদুনা	ꯐꯥꯗꯨꯅ
ফাদে	ꯐꯥꯗꯦ
ফাদ্রিঙৈদা	ꯐꯥꯗꯔꯤꯉꯩꯗ
ফাদ্রিবা	ꯐꯥꯗꯔꯤꯕ
ফাননবা	ꯐꯥꯅꯅꯕ
ফানবা	ꯐꯥꯅꯕ
ফানা	ꯐꯥꯅꯥ
ফাবগা	ꯐꯥꯕꯒ
ফাবগী	ꯐꯥꯕꯒꯤ
ফাবদা	ꯐꯥꯕꯗ
ফাবা	ꯐꯥꯕꯥ
ফারকপগা	ꯐꯥꯔꯛꯄꯒ
ফারকপদা	ꯐꯥꯔꯛꯄꯗ
ফারকপা	ꯐꯥꯔꯛꯄ
ফারক্লবা	ꯐꯥꯔꯛꯂꯕꯥ
ফারক্লে	ꯐꯥꯔꯛꯂꯦ
ফারগা	ꯐꯥꯔꯒ
ফারদুনা	ꯐꯥꯔꯗꯨꯅꯥ
ফারবনি	ꯐꯥꯔꯕꯅꯤ
ফারবশিং	ꯐꯥꯔꯕꯁꯤꯡ
ফারবা	ꯐꯥꯔꯕ
ফারম্মী	ꯐꯥꯔꯝꯃꯤ
ফারিবা	ꯐꯥꯔꯤꯕ
ফারে	ꯐꯥꯔꯦ
ফার্ম	ꯐꯥꯔꯝ
ফার্মগী	ꯐꯥꯔꯝꯒꯤ
ফার্মদা	ꯐꯥꯔꯝꯗ
ফার্মর	ꯐꯥꯔꯃꯔ
ফার্মশিং	ꯐꯥꯔꯝꯁꯤꯡ
ফার্মশিংগী	ꯐꯥꯔꯝꯁꯤꯡꯒꯤ
ফার্মশিংদা	ꯐꯥꯔꯝꯁꯤꯡꯗ
ফার্মশিংনা	ꯐꯥꯔꯝꯁꯤꯡꯅ
ফার্মাসি	ꯐꯥꯔꯃꯥꯁꯤ
ফার্মিং	ꯐꯥꯔꯃꯤꯡ
ফার্মিংগী	ꯐꯥꯔꯃꯤꯡꯒꯤ
ফালি	ꯐꯥꯂꯤ
ফাষ্ট	ꯐꯥ꯭ꯁꯠ
ফাহন্দুনা	ꯐꯥꯍꯟꯗꯨꯅꯥ
ফাহন্নবা	ꯐꯥꯍꯟꯅꯕ
ফি	ꯐꯤ
ফিক্স	ꯐꯤꯛꯁ
ফিগী	ꯐꯤꯒꯤ
ফিচর	ꯐꯤꯆꯔ
ফিজিও	ꯐꯤꯖꯤꯑꯣ
ফিজিকেল	ꯐꯤꯖꯤꯀꯦꯜ
ফিজেৎ	ꯐꯤꯖꯦꯠ
ফিট	ꯐꯤꯠ
ফিটনেস	ꯐꯤꯠꯅꯦꯁ
ফিটরগী	ꯐꯤꯇꯔꯒꯤ
ফিদম	ꯐꯤꯗꯝ
ফিদম্নফম	ꯐꯤꯗꯝꯅꯐꯝ
ফিদা	ꯐꯤꯗꯥ
ফিদিং	ꯐꯤꯗꯤꯡ
ফিফা	ꯐꯤꯐꯥ
ফিবম	ꯐꯤꯕꯝ
ফিবর	ꯐꯤꯕꯔ
ফিভম	ꯐꯤꯚꯝ
ফিভমগী	ꯐꯤꯚꯝꯒꯤ
ফিভমদা	ꯐꯤꯚꯝꯗ
ফিভমশিং	ꯐꯤꯚꯝꯁꯤꯡ
ফিরাল	ꯐꯤꯔꯥꯜ
ফিরালদা	ꯐꯤꯔꯥꯜꯗ
ফিরালনা	ꯐꯤꯔꯥꯜꯅ
ফিরেপ	ꯐꯤꯔꯦꯞ
ফিরেপকা	ꯐꯤꯔꯦꯞꯀ
ফিরেপশিং	ꯐꯤꯔꯦꯞꯁꯤꯡ
ফিলমগী	ꯐꯤꯂꯝꯒꯤ
ফিল্ড	ꯐꯤꯜꯗ
ফিল্ডদা	ꯐꯤꯜꯗꯗꯥ
ফিল্ম	ꯐꯤꯂꯝ
ফিল্মগী	ꯐꯤꯂꯝꯒꯤ
ফিল্মদা	ꯐꯤꯂꯝꯗ
ফিল্মশিং	ꯐꯤꯂꯝꯁꯤꯡ
ফিল্মশিংগী	ꯐꯤꯂꯝꯁꯤꯡꯒꯤ
ফিল্মশিংদা	ꯐꯤꯂꯝꯁꯤꯡꯗ
ফিল্মস	ꯐꯤꯂꯝꯁ
ফিল্মসু	ꯐꯤꯂꯝꯁꯨ
ফিশা	ꯐꯤꯁꯥ
ফিশাবগী	ꯐꯤꯁꯥꯕꯒꯤ
ফিশাবী	ꯐꯤꯁꯥꯕꯤ
ফিশাবীশিংদা	ꯐꯤꯁꯥꯕꯤꯁꯤꯡꯗ
ফিস	ꯐꯤꯁ
ফিসরিজ	ꯐꯤꯁꯔꯤꯖ
ফিয়ার	ꯐꯤꯌꯥꯔ
ফীবম	ꯐꯤꯕꯝ
ফীবমদা	ꯐꯤꯕꯝꯗꯥ
ফু	ꯐꯨ
ফুংয়ার	ꯐꯨꯡꯌꯥꯔ
ফুক	ꯐꯨꯀ
ফুঙ্গা	ꯐꯨꯡꯒ
ফুট	ꯐꯨꯠ
ফুদ	ꯐꯨꯗ
ফুদা	ꯐꯨꯗꯥ
ফুনবগী	ꯐꯨꯟꯕꯒꯤ
ফুবা	ꯐꯨꯕ
ফুবি	ꯐꯨꯕꯤ
ফুমদি	ꯐꯨꯝꯗꯤ
ফুম্বা	ꯐꯨꯝꯕ
ফুম্লম্বা	ꯐꯨꯝꯂꯝꯕ
ফুরুপ	ꯐꯨꯔꯨꯞ
ফুরুপকী	ꯐꯨꯔꯨꯞꯀꯤ
ফুরুপনা	ꯐꯨꯔꯨꯞꯅ
ফুরুপশিং	ꯐꯨꯔꯨꯞꯁꯤꯡ
ফুরুপশিংগী	ꯐꯨꯔꯨꯞꯁꯤꯡꯒꯤ
ফুল	ꯐꯨꯜ
ফেক	ꯐꯦꯛ
ফেকল্টি	ꯐꯦꯀꯜꯇꯤ
ফেজ	ꯐꯦꯖ
ফেজকী	ꯐꯦꯖꯀꯤ
ফেদরেল	ꯐꯦꯗꯔꯦꯜ
ফেদরেলিজমগী	ꯐꯦꯗꯔꯦꯂꯤꯖꯝꯒꯤ
ফেদরেসন	ꯐꯦꯗꯔꯦꯁꯟ
ফেদরেসনগী	ꯐꯦꯗꯔꯦꯁꯟꯒꯤ
ফেদরেসননা	ꯐꯦꯗꯔꯦꯁꯟꯅ
ফেন	ꯐꯦꯟ
ফেনশিংগী	ꯐꯦꯟꯁꯤꯡꯒꯤ
ফেন্টাসি	ꯐꯦꯟꯇꯥꯁꯤ
ফেন্সিং	ꯐꯦꯟꯁꯤꯡ
ফেবু্রৱারি	ꯐꯦꯕꯨꯔꯋꯥꯔꯤ
ফেবু্রৱারী	ꯐꯦꯕꯨꯔꯋꯥꯔꯤ
ফেব্রুৱারি	ꯐꯦꯕꯔꯨꯋꯥꯔꯤ
ফেব্রুৱারিদা	ꯐꯦꯕꯔꯨꯋꯥꯔꯤꯗ
ফেব্রুৱারী	ꯐꯦꯕꯔꯨꯋꯥꯔꯤ
ফেব্রুৱারীদা	ꯐꯦꯕꯔꯨꯋꯥꯔꯤꯗ
ফেম	ꯐꯦꯝ
ফেমিলি	ꯐꯦꯃꯤꯂꯤ
ফেমিলিগী	ꯐꯦꯃꯤꯂꯤꯒꯤ
ফেল	ꯐꯦꯜ
ফেষ্টিবেল	ꯐꯦꯁꯇꯤꯕꯦꯜ
ফেষ্টিবেলগী	ꯐꯦꯁꯇꯤꯕꯦꯜꯒꯤ
ফেষ্টিবেলদা	ꯐꯦꯁꯇꯤꯕꯦꯜꯗ
ফেষ্টিবেলশিং	ꯐꯦꯁꯇꯤꯕꯦꯜꯁꯤꯡ
ফেষ্টিভেল	ꯐꯦꯁꯇꯤꯚꯦꯜ
ফেষ্টিভেলগী	ꯐꯦꯁꯇꯤꯚꯦꯜꯒꯤ
ফেষ্টিভেলদা	ꯐꯦꯁꯇꯤꯚꯦꯜꯗ
ফেস	ꯐꯦꯁ
ফেসন	ꯐꯦꯁꯟ
ফেসবুক	ꯐꯦꯁꯕꯨꯛ
ফেসিলিটি	ꯐꯦꯁꯤꯂꯤꯇꯤ
ফেসিলিটিদা	ꯐꯦꯁꯤꯂꯤꯇꯤꯗ
ফেসিলিটিশিং	ꯐꯦꯁꯤꯂꯤꯇꯤꯁꯤꯡ
ফেয়র	ꯐꯦꯪꯌꯔ
ফৈ	ꯐꯩ
ফৈজুপ	ꯐꯩꯖꯨꯄ
ফৈদা	ꯐꯩꯗꯥ
ফৈনা	ꯐꯩꯅꯥ
ফ্রন্ট	ꯐ꯭ꯔꯟꯠ
ফ্রন্টকী	ꯐ꯭ꯔꯟꯠꯀꯤ
ফ্রন্টলাইন	ꯐ꯭ꯔꯟꯠꯂꯥꯏꯟ
ফ্রন্টেল	ꯐ꯭ꯔꯟꯇꯦꯜ
ফ্রাইদ	ꯐ꯭ꯔꯥꯏꯗ
ফ্রাইদে	ꯐ꯭ꯔꯥꯏꯗꯦ
ফ্রান্স	ꯐ꯭ꯔꯥꯟꯁ
ফ্রান্সকা	ꯐ꯭ꯔꯥꯟꯁꯀ
ফ্রান্সকী	ꯐ꯭ꯔꯥꯟꯁꯀꯤ
ফ্রান্সতা	ꯐ꯭ꯔꯥꯟꯁꯇ
ফ্রান্সনা	ꯐ꯭ꯔꯥꯟꯁꯅ
ফ্রান্সিস	ꯐ꯭ꯔꯥꯟꯁꯤꯁ
ফ্রি	ꯐ꯭ꯔꯤ
ফ্রিদম	ꯐꯔꯤꯗꯝ
ফ্রেঞ্চ	ꯐ꯭ꯔꯦꯟꯆ
ফ্রেন্দলি	ꯐ꯭ꯔꯦꯟꯗꯂꯤ
ফ্রেন্দশিপ	ꯐꯔꯦꯟꯗꯁꯤꯄ
ফ্রেন্দস	ꯐꯔꯦꯟꯗꯁ
ফ্রেন্স	ꯐ꯭ꯔꯦꯟꯁ
ফ্রেম	ꯐ꯭ꯔꯦꯝ
ফ্রেমৱার্ক	ꯐ꯭ꯔꯦꯝꯋꯥ꯭ꯔꯛ
ফ্রেস	ꯐ꯭ꯔꯦꯁ
ফ্লাই	ꯐ꯭ꯂꯥꯏ
ফ্লাইট	ꯐ꯭ꯂꯥꯏꯇ
ফ্লাইটকী	ꯐ꯭ꯂꯥꯏꯠꯀꯤ
ফ্লাইটতা	ꯐ꯭ꯂꯥꯏꯠꯇ
ফ্লাইটশিং	ꯐ꯭ꯂꯥꯏꯠꯁꯤꯡ
ফ্লাইটশিংদা	ꯐ꯭ꯂꯥꯏꯠꯁꯤꯡꯗ
ফ্লাইটশিংদি	ꯐ꯭ꯂꯥꯏꯠꯁꯤꯡꯗꯤ
ফ্লু	ꯐꯂꯨ
ফ্লুগী	ꯐꯂꯨꯒꯤ
ফ্লুনি	ꯐꯂꯨꯅꯤ
ফ্লেগ	ꯐ꯭ꯂꯦꯒ
ফ্লৱার	ꯐꯂꯋꯥꯔ
ফয়ার	ꯐꯌꯥꯔ
ফয়ারগী	ꯐꯌꯥꯔꯒꯤ
ব	ꯕ
বক	ꯕꯛ
বগান	ꯕꯒꯥꯟ
বগানগী	ꯕꯒꯥꯟꯒꯤ
বঙ্ক	ꯕꯡꯀ
বঙ্গলা	ꯕꯪꯒꯂꯥ
বঙ্গলাদেশ	ꯕꯪꯒꯂꯥꯗꯦꯁ
বঙ্গলাদেশকা	ꯕꯪꯒꯂꯥꯗꯦꯁꯀ
বঙ্গলাদেশকী	ꯕꯪꯒꯂꯥꯗꯦꯁꯀꯤ
বঙ্গলাদেশতা	ꯕꯪꯒꯂꯥꯗꯦꯁꯇ
বঙ্গলাদেস	ꯕꯪꯒꯂꯥꯗꯦꯁ
বঙ্গলাদেসকী	ꯕꯪꯒꯂꯥꯗꯦꯁꯀꯤ
বঙ্গলাদেসতা	ꯕꯪꯒꯂꯥꯗꯦꯁꯇ
বচাও	ꯕꯆꯥꯑꯣ
বজাজ	ꯕꯖꯥꯖ
বজার	ꯕꯖꯥꯔ
বজারগী	ꯕꯖꯥꯔꯒꯤ
বজারদগী	ꯕꯖꯥꯔꯗꯒꯤ
বজারদা	ꯕꯖꯥꯔꯗ
বজেট	ꯕꯖꯦꯠ
বজেটকী	ꯕꯖꯦꯠꯀꯤ
বটালিয়ন	ꯕꯇꯥꯂꯤꯌꯟ
বটালিয়নগী	ꯕꯇꯥꯂꯤꯌꯟꯒꯤ
বদনাম	ꯕꯗꯅꯥꯝ
বধর্ন	ꯕꯙꯔꯟ
বধর্ননা	ꯕꯙꯔꯟꯅ
বন্দ	ꯕꯟꯗ
বন্দনা	ꯕꯟꯗꯅꯥ
বন্দে	ꯕꯟꯗꯦ
বফর	ꯕꯐꯔ
ববিনা	ꯕꯕꯤꯅꯥ
বম্বুলা	ꯕꯝꯕꯨꯂꯥ
বর	ꯕꯔ
বরাক	ꯕꯔꯥꯛ
বর্ধন	ꯕꯔꯙꯟ
বর্ধননা	ꯕꯔꯙꯟꯅ
বলরাম	ꯕꯜꯔꯥꯝ
বলা	ꯕꯂꯥ
বশিংগী	ꯕꯁꯤꯪꯒꯤ
বস	ꯕꯁ
বসকী	ꯕꯁꯀꯤ
বসশিং	ꯕꯁꯁꯤꯡ
বসির	ꯕꯁꯤꯔ
বহাদুর	ꯕꯍꯥꯗꯨꯔ
বা	ꯕꯥ
বাই	ꯕꯥꯏ
বাইও	ꯕꯥꯏꯑꯣ
বাইওটেকনা	ꯕꯥꯏꯑꯣꯇꯦꯛꯅ
বাইক	ꯕꯥꯏꯛ
বাইকর	ꯕꯥꯏꯀꯔ
বাইজালনা	ꯕꯥꯏꯖꯥꯜꯅ
বাইদেননা	ꯕꯥꯏꯗꯦꯟꯅ
বাইবল	ꯕꯥꯏꯕꯜ
বাইলেটরেল	ꯕꯥꯏꯂꯦꯇꯔꯦꯜ
বাগ	ꯕꯥꯒ
বাব	ꯕꯥꯕ
বাবা	ꯕꯥꯕꯥ
বাবাগী	ꯕꯥꯕꯥꯒꯤ
বাবিনা	ꯕꯥꯕꯤꯅ
বাবু	ꯕꯥꯕꯨ
বাবুনা	ꯕꯥꯕꯨꯅ
বাবুপারাদা	ꯕꯥꯕꯨꯄꯥꯔꯥꯗ
বার	ꯕꯥꯔ
বারশিং	ꯕꯥꯔꯁꯤꯡ
বার্তন	ꯕꯥꯔꯇꯟ
বার্দ	ꯕꯥ꯭ꯔꯗ
বাল	ꯕꯥꯜ
বালা	ꯕꯥꯂꯥ
বাসি	ꯕꯥꯁꯤ
বাসুনা	ꯕꯥꯁꯨꯅ
বাসুম	ꯕꯥꯁꯨꯝ
বি	ꯕꯤ
বিগ	ꯕꯤꯒ
বিগী	ꯕꯤꯒꯤ
বিচার	ꯕꯤꯆꯥꯔ
বিজাৎ	ꯕꯤꯖꯥꯠ
বিজায়ননা	ꯕꯤꯖꯥꯌꯅꯅ
বিজিনেস	ꯕꯤꯖꯤꯅꯦꯁ
বিজু	ꯕꯤꯖꯨ
বিজেপি	ꯕꯤꯖꯦꯄꯤ
বিজয়	ꯕꯤꯖꯩ
বিজয়না	ꯕꯤꯖꯩꯅ
বিট	ꯕꯤꯠ
বিদায়	ꯕꯤꯗꯥꯌ
বিধান	ꯕꯤꯙꯥꯟ
বিন	ꯕꯤꯟ
বিনা	ꯕꯤꯅꯥ
বিনিফিসরি	ꯕꯤꯅꯤꯐꯤꯁꯔꯤ
বিনিফিসরিশিংগী	ꯕꯤꯅꯤꯐꯤꯁꯔꯤꯁꯤꯡꯒꯤ
বিনিফিসরিশিংদা	ꯕꯤꯅꯤꯐꯤꯁꯔꯤꯁꯤꯡꯗ
বিনয়	ꯕꯤꯅꯣꯢ
বিপিন	ꯕꯤꯄꯤꯟ
বিপিনচন্দ্রনা	ꯕꯤꯄꯤꯟꯆꯟꯗ꯭ꯔꯅ
বিপ্লব	ꯕꯤꯄ꯭ꯂꯕ
বিবু	ꯕꯤꯕꯨ
বিবেকানন্দ	ꯕꯤꯕꯦꯀꯥꯅꯟꯗ
বিবেকানন্দগী	ꯕꯤꯕꯦꯀꯥꯅꯟꯗꯒꯤ
বিবেকানন্দনা	ꯕꯤꯕꯦꯀꯥꯅꯟꯗꯅ
বিভাগনা	ꯕꯤꯚꯥꯒꯅꯥ
বির	ꯕꯤꯔꯦꯟ
বিরকুমার	ꯕꯤꯔꯀꯨꯃꯥꯔ
বিরভুম	ꯕꯤꯔꯚꯨꯝ
বিরভুমগী	ꯕꯤꯔꯚꯨꯝꯒꯤ
বিরমঙ্গল	ꯕꯤꯔꯃꯪꯒꯜ
বিরা	ꯕꯤꯔꯥ
বিরেনগা	ꯕꯤꯔꯦꯟꯒ
বিরেনগী	ꯕꯤꯔꯦꯟꯒꯤ
বিরেনদা	ꯕꯤꯔꯦꯟꯗ
বিরেননা	ꯕꯤꯔꯦꯟꯅ
বিরেনবু	ꯕꯤꯔꯦꯟꯕꯨ
বিরেন্নসু	ꯕꯤꯔꯦꯟꯅꯁꯨ
বিরেন্না	ꯕꯤꯔꯦꯟꯅ
বিল	ꯕꯤꯜ
বিলাস	ꯕꯤꯂꯥꯁ
বিলাসিনি	ꯕꯤꯂꯥꯁꯤꯅꯤ
বিলিয়ন	ꯕꯤꯂꯤꯌꯟ
বিল্ডিং	ꯕꯤꯜꯗꯤꯡ
বিল্ডিংনচিংবা	ꯕꯤꯜꯗꯤꯡꯅꯆꯤꯡꯕ
বিল্ডিংশিং	ꯕꯤꯜꯗꯤꯡꯁꯤꯡ
বিল্লিয়ন	ꯕꯤꯜꯂꯤꯌꯟ
বিশ্ব	ꯕꯤꯁ꯭ꯋ
বিশ্বজিৎ	ꯕꯤꯁ꯭ꯋꯖꯤꯠ
বিশ্বজিৎনা	ꯕꯤꯁ꯭ꯋꯖꯤꯠꯅ
বিশ্বা	ꯕꯤꯁ꯭ꯋꯥ
বিশ্বাসনা	ꯕꯤꯁ꯭ꯋꯥꯁꯅ
বিষ্ণু	ꯕꯤꯁꯅꯨ
বিষ্ণুপুর	ꯕꯤꯁꯅꯨꯄꯨꯔ
বিষ্ণুপুরগী	ꯕꯤꯁꯅꯨꯄꯨꯔꯒꯤ
বিষ্ণুপুরদগী	ꯕꯤꯁꯅꯨꯄꯨꯔꯗꯒꯤ
বিষ্ণুপুরদা	ꯕꯤꯁꯅꯨꯄꯨꯔꯗ
বিহার	ꯕꯤꯍꯥꯔ
বিহারগী	ꯕꯤꯍꯥꯔꯒꯤ
বিহারদা	ꯕꯤꯍꯥꯔꯗ
বিহারি	ꯕꯤꯍꯥꯔꯤ
বিহু	ꯕꯤꯍꯨ
বিহেবিয়র	ꯕꯤꯍꯦꯕꯤꯌꯔ
বী	ꯕꯤ
বু	ꯕꯨ
বুংজাগিন	ꯕꯨꯙꯖꯥꯒꯤꯟ
বুক	ꯕꯨꯛ
বুকশিং	ꯕꯨꯛꯁꯤꯡ
বুক্কিং	ꯕꯨꯛꯀꯤꯡ
বুট	ꯕꯨꯠ
বুধচন্দ্র	ꯕꯨꯙꯆꯟꯗ꯭ꯔ
বৃটিশ	ꯕ꯭ꯔꯤꯇꯤꯁ
বৃটিশকা	ꯕ꯭ꯔꯤꯇꯤꯁꯀ
বৃটিশকী	ꯕ꯭ꯔꯤꯇꯤꯁꯀꯤ
বৃটিশনা	ꯕ꯭ꯔꯤꯇꯤꯁꯅ
বৃটিশশিংগা	ꯕ꯭ꯔꯤꯇꯤꯁꯁꯤꯡꯒ
বৃটিশশিংনা	ꯕ꯭ꯔꯤꯇꯤꯁꯁꯤꯡꯅ
বৃটেন	ꯕ꯭ꯔꯤꯇꯦꯟ
বৃটেনগী	ꯕ꯭ꯔꯤꯇꯦꯟꯒꯤ
বৃন্দা	ꯕ꯭ꯔꯤꯟꯗꯥ
বেক	ꯕꯦꯛ
বেগ	ꯕꯦꯒ
বেগতা	ꯕꯦꯒꯇ
বেঙ্ক	ꯕꯦꯡꯛ
বেঙ্ককী	ꯕꯦꯡꯛꯀꯤ
বেঙ্কতগী	ꯕꯦꯡꯛꯇꯒꯤ
বেঙ্কতা	ꯕꯦꯡꯛꯇ
বেঙ্কনা	ꯕꯦꯡꯛꯅ
বেঙ্কশিংগা	ꯕꯦꯡꯛꯁꯤꯡꯒ
বেঙ্কশিংগী	ꯕꯦꯡꯛꯁꯤꯡꯒꯤ
বেঙ্কশিংদা	ꯕꯦꯡꯛꯁꯤꯡꯗ
বেঙ্কশিংনা	ꯕꯦꯡꯛꯁꯤꯡꯅ
বেঙ্গল	ꯕꯦꯡꯒꯜ
বেঙ্গলগী	ꯕꯦꯡꯒꯜꯒꯤ
বেঙ্গলদগী	ꯕꯦꯡꯒꯜꯗꯒꯤ
বেঙ্গলদসু	ꯕꯦꯡꯒꯜꯗꯁꯨ
বেঙ্গলদা	ꯕꯦꯡꯒꯜꯗ
বেঙ্গলি	ꯕꯦꯡꯒꯂꯤ
বেঙ্গলুরু	ꯕꯦꯡꯒꯂꯨꯔꯨ
বেঙ্গলুরুদা	ꯕꯦꯡꯒꯂꯨꯔꯨꯗ
বেঙ্গুন	ꯕꯦꯡꯒꯨꯟ
বেজ	ꯕꯦꯖ
বেজতা	ꯕꯦꯖꯇ
বেজদা	ꯕꯦꯖꯗ
বেঞ্চ	ꯕꯦꯟꯆ
বেঞ্চনা	ꯕꯦꯟꯆꯅ
বেটচ	ꯕꯦꯠꯆ
বেটরি	ꯕꯦꯇꯔꯤ
বেটিং	ꯕꯦꯇꯤꯡ
বেতি	ꯕꯦꯇꯤ
বেদ	ꯕꯦꯗ
বেদমিন্টন	ꯕꯦꯗꯃꯤꯟꯇꯟ
বেন	ꯕꯦꯟ
বেনর্জি	ꯕꯦꯅꯔꯖꯤ
বেনর্জিনা	ꯕꯦꯅꯔꯖꯤꯅ
বেনিফিট	ꯕꯦꯅꯤꯐꯤꯠ
বেনিফিসরি	ꯕꯦꯅꯤꯐꯤꯁꯔꯤ
বেন্দ	ꯕꯦꯟꯗ
বেন্দনা	ꯕꯦꯟꯗꯅ
বেন্নর	ꯕꯦꯟꯅꯔ
বেম্বু	ꯕꯦꯝꯕꯨ
বেরেক	ꯕꯦꯔꯦꯛ
বেল	ꯕꯦꯜ
বেলজিয়মগী	ꯕꯦꯜꯖꯤꯌꯝꯒꯤ
বেলদা	ꯕꯦꯜꯗ
বেলি	ꯕꯦꯂꯤ
বেলেন্স	ꯕꯦꯂꯦꯟꯁ
বেলেন্সতা	ꯕꯦꯂꯦꯟꯁꯇ
বেল্লি	ꯕꯦꯜꯂꯤ
বেষ্ট	ꯕꯦ꯭ꯁꯠ
বেস	ꯕꯦꯁ
বেসিক	ꯕꯦꯁꯤꯛ
বেসিষ্টতা	ꯕꯦꯁꯤ꯭ꯁꯠꯇ
বেসিস	ꯕꯦꯁꯤꯁ
বেসিসতা	ꯕꯦꯁꯤꯁꯇ
বেসিস্তা	ꯕꯦꯁꯤꯁꯇ
বৈজিং	ꯕꯩꯖꯤꯡ
বৈজিংদা	ꯕꯩꯖꯤꯡꯗ
ব্রজবাসি	ꯕ꯭ꯔꯖꯕꯁꯤ
ব্রজবাসিগী	ꯕ꯭ꯔꯖꯕꯥꯁꯤꯒꯤ
ব্রহ্মপুর	ꯕ꯭ꯔꯍꯃꯄꯨꯔ
ব্রহ্মপুরদগী	ꯕ꯭ꯔꯍꯃꯄꯨꯔꯗꯒꯤ
ব্রাইন	ꯕꯔꯥꯏꯟ
ব্রাজিল	ꯕꯔꯥꯖꯤꯜ
ব্রাজিলগী	ꯕꯔꯥꯖꯤꯜꯒꯤ
ব্রাজিলদা	ꯕꯔꯥꯖꯤꯜꯗ
ব্রাজিলবু	ꯕꯔꯥꯖꯤꯜꯕꯨ
ব্রাঞ্চ	ꯕꯔꯥꯟꯆ
ব্রান্দ	ꯕꯔꯥꯟꯗ
ব্রিক	ꯕ꯭ꯔꯤꯛ
ব্রিগেদিয়র	ꯕ꯭ꯔꯤꯒꯦꯗꯤꯌꯔ
ব্রিজ	ꯕ꯭ꯔꯤꯖ
ব্রিজগী	ꯕ꯭ꯔꯤꯖꯒꯤ
ব্রিন্দা	ꯕ꯭ꯔꯤꯟꯗꯥ
ব্রিন্দানা	ꯕ꯭ꯔꯤꯟꯗꯥꯅ
ব্রু	ꯕ꯭ꯔꯨ
ব্রেক	ꯕ꯭ꯔꯦꯛ
ব্রেন	ꯕ꯭ꯔꯦꯟ
ব্রেষ্ট	ꯕ꯭ꯔꯦꯁꯠ
ব্রোজেন	ꯕ꯭ꯔꯣꯖꯦꯟ
ব্রোজেননা	ꯕ꯭ꯔꯣꯖꯦꯟꯅ
ব্রোজেন্না	ꯕ꯭ꯔꯣꯖꯦꯟꯅ
ব্রোঞ্জ	ꯕ꯭ꯔꯣꯟꯖ
ব্রোদ	ꯕ꯭ꯔꯣꯗ
ব্রোদকাষ্টিং	ꯕ꯭ꯔꯣꯗꯀꯥꯁꯇꯤꯡ
ব্লদ	ꯕ꯭ꯂꯗ
ব্লু	ꯕ꯭ꯂꯨ
ব্লেক	ꯕ꯭ꯂꯦꯛ
ভ	ꯚ
ভগবদ	ꯚꯒꯕꯗ
ভগবান	ꯚꯒꯕꯥꯟ
ভন্দারিনা	ꯚꯟꯗꯥꯔꯤꯅ
ভবন	ꯚꯕꯟ
ভবনদা	ꯚꯕꯟꯗ
ভরতকী	ꯚꯔꯠꯀꯤ
ভরসেস	ꯚꯔꯁꯦꯁ
ভলুন্টরি	ꯚꯂꯨꯟꯇꯔꯤ
ভলুন্টিয়ার	ꯚꯂꯨꯟꯇꯤꯌꯥꯔ
ভাই	ꯚꯥꯏ
ভাইওলেন্স	ꯚꯥꯏꯑꯣꯂꯦꯟꯁ
ভাইওলেন্সকী	ꯚꯥꯏꯑꯣꯂꯦꯟꯁꯀꯤ
ভাইরস	ꯚꯥꯏꯔꯁ
ভাইরসকী	ꯚꯥꯏꯔꯁꯀꯤ
ভাইরসতগী	ꯚꯥꯏꯔꯁꯇꯒꯤ
ভাইরসতা	ꯚꯥꯏꯔꯁꯇ
ভাইরসনা	ꯚꯥꯏꯔꯁꯅ
ভাইরেল	ꯚꯥꯏꯔꯦꯜ
ভাইস	ꯚꯥꯏꯁ
ভাইসর	ꯚꯥꯏꯁꯔ
ভান	ꯚꯥꯟ
ভাব	ꯚꯥꯕ
ভাবন	ꯚꯥꯕꯟ
ভাবনদা	ꯚꯥꯕꯟꯗ
ভারত	ꯚꯥꯔꯠ
ভারতকী	ꯚꯥꯔꯠꯀꯤ
ভারতকীদমক	ꯚꯥꯔꯠꯀꯤꯗꯃꯛ
ভারতগী	ꯚꯥꯔꯠꯒꯤ
ভারততা	ꯚꯥꯔꯠꯇ
ভারতনা	ꯚꯥꯔꯠꯅ
ভারতপু	ꯚꯥꯔꯠꯄꯨ
ভারতি	ꯚꯥꯔꯇꯤ
ভারতিগী	ꯚꯥꯔꯇꯤꯒꯤ
ভারতিয়া	ꯚꯥꯔꯇꯤꯌꯥ
ভারত্তগী	ꯚꯥꯔꯠꯇꯒꯤ
ভারত্তা	ꯚꯥꯔꯠꯇ
ভারা	ꯚꯥꯔꯥ
ভারাগী	ꯚꯥꯔꯥꯒꯤ
ভারাসু	ꯚꯥꯔꯥꯁꯨ
ভাষন	ꯚꯥꯁꯟ
ভাসুম	ꯚꯥꯁꯨꯝ
ভি	ꯚꯤ
ভিজন	ꯚꯤꯖꯟ
ভিজা	ꯚꯤꯖꯥ
ভিজিটরশিং	ꯚꯤꯖꯤꯇꯔꯁꯤꯡ
ভিজিলেন্স	ꯚꯤꯖꯤꯂꯦꯟꯁ
ভিজুয়েল	ꯚꯤꯖꯨꯌꯦꯜ
ভিদা	ꯚꯤꯗꯥ
ভিদিও	ꯚꯤꯗꯤꯑꯣ
ভিদিওগী	ꯚꯤꯗꯤꯑꯣꯒꯤ
ভিদিওশিং	ꯚꯤꯗꯤꯑꯣꯁꯤꯡ
ভিপি	ꯚꯤꯄꯤ
ভিম	ꯚꯤꯝ
ভিলেজ	ꯚꯤꯂꯦꯖ
ভিলেজকী	ꯚꯤꯂꯦꯖꯀꯤ
ভিলেজতা	ꯚꯤꯂꯦꯖꯇ
ভিলেজদা	ꯚꯤꯂꯦꯖꯗ
ভিল্লেজ	ꯚꯤꯜꯂꯦꯖ
ভিসা	ꯚꯤꯁꯥ
ভিয়েটনাম	ꯚꯤꯌꯦꯠꯅꯥꯝ
ভিয়েটনামগী	ꯚꯤꯌꯦꯠꯅꯥꯝꯒꯤ
ভুংজাগিন	ꯚꯨꯡꯖꯥꯒꯤꯟ
ভুটান	ꯚꯨꯇꯥꯟ
ভুটানদা	ꯚꯨꯇꯥꯟꯗ
ভুতানগী	ꯚꯨꯇꯥꯟꯒꯤ
ভুতানদা	ꯚꯨꯇꯥꯟꯗ
ভুতানবু	ꯚꯨꯇꯥꯟꯕꯨ
ভুপেস	ꯚꯨꯄꯦꯁ
ভুবন	ꯚꯨꯕꯟ
ভুবনেশ্বর	ꯚꯨꯕꯅꯦꯁ꯭ꯋꯔ
ভুবনেশ্বরদা	ꯚꯨꯕꯅꯦꯁ꯭ꯋꯔꯗ
ভুমলুনমাং	ꯚꯨꯝꯂꯨꯟꯃꯥꯡ
ভুমলুনমাংনা	ꯚꯨꯝꯂꯨꯟꯃꯥꯡꯅ
ভুমি	ꯚꯨꯃꯤ
ভুসন	ꯚꯨꯁꯟ
ভূত	ꯚꯨꯇ
ভেক্সি	ꯚꯦꯛꯁꯤ
ভেক্সিন	ꯚꯦꯛꯁꯤꯟ
ভেক্সিনগী	ꯚꯦꯛꯁꯤꯟꯒꯤ
ভেক্সিনদি	ꯚꯦꯛꯁꯤꯟꯗꯤ
ভেক্সিননি	ꯚꯦꯛꯁꯤꯟꯅꯤ
ভেক্সিনশিং	ꯚꯦꯛꯁꯤꯟꯁꯤꯡ
ভেক্সিনেসন	ꯚꯦꯛꯁꯤꯅꯦꯁꯟ
ভেক্সিনেসনগী	ꯚꯦꯛꯁꯤꯅꯦꯁꯟꯒꯤ
ভেঞ্চর	ꯚꯦꯟꯆꯔ
ভেটরান	ꯚꯦꯇꯔꯥꯟ
ভেটরিনারি	ꯚꯦꯇꯔꯤꯅꯥꯔꯤ
ভেন	ꯚꯦꯟ
ভেনকয়া	ꯚꯦꯟꯀꯌꯥ
ভেনগী	ꯚꯦꯟꯒꯤ
ভেনিস	ꯚꯦꯅꯤꯁ
ভেন্টিলেটর	ꯚꯦꯟꯇꯤꯂꯦꯇꯔ
ভেন্টিলেটরগী	ꯚꯦꯟꯇꯤꯂꯦꯇꯔꯒꯤ
ভেন্দর	ꯚꯦꯟꯗꯔ
ভেরিফিকেসন	ꯚꯦꯔꯤꯐꯤꯀꯦꯁꯟ
ভেলিট	ꯚꯦꯂꯤꯠ
ভেলেন্তিনা	ꯚꯦꯂꯦꯟꯇꯤꯅꯥ
ভেল্লিগী	ꯚꯦꯜꯂꯤꯒꯤ
ভেল্লিদা	ꯚꯦꯜꯂꯤꯗ
ভেহিকল	ꯚꯦꯍꯤꯀꯜ
ম	ꯃ
মংলান	ꯃꯪꯂꯥꯟ
মওং	ꯃꯑꯣꯡ
মওংগী	ꯃꯑꯣꯡꯒꯤ
মওংদগী	ꯃꯑꯣꯡꯗꯒꯤ
মওংদা	ꯃꯑꯣꯡꯗꯥ
মওংদি	ꯃꯑꯣꯡꯗꯤ
মওংনি	ꯃꯑꯣꯡꯅꯤ
মওংশিং	ꯃꯑꯣꯡꯁꯤꯡ
মওংসু	ꯃꯑꯣꯡꯁꯨ
মক	ꯃꯛ
মকা	ꯃꯀꯥ
মকু	ꯃꯀꯨ
মকুগী	ꯃꯀꯨꯒꯤ
মকুনা	ꯃꯀꯨꯅꯥ
মকৈ	ꯃꯀꯩ
মক্কা	ꯃꯛꯀꯥ
মক্কী	ꯃꯛꯀꯤ
মখদা	ꯃꯈꯗꯥ
মখল	ꯃꯈꯜ
মখলগী	ꯃꯈꯜꯒꯤ
মখলশিং	ꯃꯈꯜꯁꯤꯡ
মখলশিংনি	ꯃꯈꯜꯁꯤꯡꯅꯤ
মখা	ꯃꯈꯥ
মখাই	ꯃꯈꯥꯏ
মখাইগী	ꯃꯈꯥꯏꯒꯤ
মখাগী	ꯃꯈꯥꯒꯤ
মখাতানা	ꯃꯈꯥꯇꯥꯅꯥ
মখাদনি	ꯃꯈꯥꯗꯅꯤ
মখাদসু	ꯃꯈꯥꯗꯁꯨ
মখাদা	ꯃꯈꯥꯗꯥ
মখায়	ꯃꯈꯥꯏ
মখায়গী	ꯃꯈꯥꯏꯒꯤ
মখায়দগী	ꯃꯈꯥꯏꯗꯒꯤ
মখায়দা	ꯃꯈꯥꯏꯗꯥ
মখায়না	ꯃꯈꯥꯏꯅꯥ
মখুত্তগী	ꯃꯈꯨꯠꯇꯒꯤ
মখুত্তা	ꯃꯈꯨꯠꯇꯥ
মখুম	ꯃꯈꯨꯃ
মখুল	ꯃꯈꯨꯂ
মখুৎ	ꯃꯈꯨꯠ
মখুৎতগী	ꯃꯈꯨꯠꯇꯒꯤ
মখৈ	ꯃꯈꯩ
মখৈদি	ꯃꯈꯩꯗꯤ
মগী	ꯃꯒꯤ
মগুন	ꯃꯒꯨꯟ
মগুনদা	ꯃꯒꯨꯟꯗꯥ
মগুনবু	ꯃꯒꯨꯟꯕꯨ
মগুনসু	ꯃꯒꯨꯟꯁꯨ
মগুন্দি	ꯃꯒꯨꯟꯗꯤ
মগুন্দু	ꯃꯒꯨꯟꯗꯨ
মগুন্না	ꯃꯒꯨꯟꯅꯥ
মঙক	ꯃꯉꯛ
মঙজরকপা	ꯃꯡꯖꯔꯛꯄꯥ
মঙফাওননবা	ꯃꯡꯐꯥꯎꯅꯅꯕꯥ
মঙফাওনবা	ꯃꯡꯐꯥꯎꯅꯕꯥ
মঙম	ꯃꯉꯝ
মঙলম্বা	ꯃꯡꯜꯝꯕꯥ
মঙলান	ꯃꯡꯂꯥꯟ
মঙলানগা	ꯃꯡꯂꯥꯟꯒꯥ
মঙা	ꯃꯉꯥ
মঙাং	ꯃꯉꯥꯡ
মঙাংনা	ꯃꯉꯥꯡꯅꯥ
মঙাই	ꯃꯉꯥꯏ
মঙাইরে	ꯃꯉꯥꯏꯔꯦ
মঙাগী	ꯃꯉꯥꯒꯤ
মঙাদগী	ꯃꯉꯥꯗꯒꯤ
মঙাদসু	ꯃꯉꯥꯗꯁꯨ
মঙাদা	ꯃꯉꯥꯗꯥ
মঙানা	ꯃꯉꯥꯅꯥ
মঙানি	ꯃꯉꯥꯅꯤ
মঙানিগী	ꯃꯉꯥꯅꯤꯒꯤ
মঙানিদা	ꯃꯉꯥꯅꯤꯗꯥ
মঙামক	ꯃꯉꯥꯃꯛ
মঙারক	ꯃꯉꯥꯔꯛ
মঙাল	ꯃꯉꯥꯜ
মঙালনা	ꯃꯉꯥꯜꯅꯥ
মঙাশুবা	ꯃꯉꯥꯁꯨꯕꯥ
মঙায়রে	ꯃꯉꯥꯏꯔꯦ
মঙ্গল	ꯃꯡꯒꯜ
মঙ্গলনা	ꯃꯡꯒꯜꯅꯥ
মঙ্গি	ꯃꯡꯒꯤ
মঙ্গিনা	ꯃꯡꯒꯤꯅꯥ
মচন	ꯃꯆꯟ
মচল	ꯃꯆꯜ
মচা	ꯃꯆꯥ
মচাক	ꯃꯆꯥꯛ
মচাকশিং	ꯃꯆꯥꯛꯁꯤꯡ
মচাকশিংগী	ꯃꯆꯥꯛꯁꯤꯡꯒꯤ
মচাকশিংদা	ꯃꯆꯥꯛꯁꯤꯡꯗꯥ
মচাগা	ꯃꯆꯥꯒꯥ
মচাগী	ꯃꯆꯥꯒꯤ
মচাদা	ꯃꯆꯥꯗꯥ
মচাদু	ꯃꯆꯥꯗꯨ
মচাদুগী	ꯃꯆꯥꯗꯨꯒꯤ
মচাদুদা	ꯃꯆꯥꯗꯨꯗꯥ
মচাদুনা	ꯃꯆꯥꯗꯨꯅꯥ
মচানা	ꯃꯆꯥꯅꯥ
মচানি	ꯃꯆꯥꯅꯤ
মচানিপা	ꯃꯆꯥꯅꯤꯄꯥ
মচানুপা	ꯃꯆꯥꯅꯨꯄꯥ
মচানুপাগী	ꯃꯆꯥꯅꯨꯄꯥꯒꯤ
মচানুপানা	ꯃꯆꯥꯅꯨꯄꯥꯅꯥ
মচানুপানি	ꯃꯆꯥꯅꯨꯄꯥꯅꯤ
মচানুপাবু	ꯃꯆꯥꯅꯨꯄꯥꯕꯨ
মচানুপী	ꯃꯆꯥꯅꯨꯄꯤ
মচানুপীগা	ꯃꯆꯥꯅꯨꯄꯤꯒꯥ
মচানুপীগী	ꯃꯆꯥꯅꯨꯄꯤꯒꯤ
মচানুপীনা	ꯃꯆꯥꯅꯨꯄꯤꯅꯥ
মচানুপীনি	ꯃꯆꯥꯅꯨꯄꯤꯅꯤ
মচানুপীবু	ꯃꯆꯥꯅꯨꯄꯤꯕꯨ
মচাবু	ꯃꯆꯥꯕꯨ
মচাশিং	ꯃꯆꯥꯁꯤꯡ
মচাশিংগা	ꯃꯆꯥꯁꯤꯡꯒꯥ
মচাশিংগী	ꯃꯆꯥꯁꯤꯡꯒꯤ
মচাশিংগীদমক	ꯃꯆꯥꯁꯤꯡꯒꯤꯗꯃꯛ
মচাশিংদা	ꯃꯆꯥꯁꯤꯡꯗꯥ
মচাশিংনা	ꯃꯆꯥꯁꯤꯡꯅꯥ
মচাশিংবু	ꯃꯆꯥꯁꯤꯡꯕꯨ
মচাশিংসু	ꯃꯆꯥꯁꯤꯡꯁꯨ
মচাসু	ꯃꯆꯥꯁꯨ
মচি	ꯃꯆꯤ
মচিঞ্জাক	ꯃꯆꯤꯟꯖꯥꯛ
মচিদা	ꯃꯆꯤꯗꯥ
মচিন	ꯃꯆꯤꯟ
মচিনা	ꯃꯆꯤꯅꯥ
মচিন্না	ꯃꯆꯤꯟꯅꯥ
মচিল	ꯃꯆꯤꯜ
মচী	ꯃꯆꯤ
মচীন	ꯃꯆꯤꯅ
মচীন্দগী	ꯃꯆꯤꯟꯗꯒꯤ
মচীন্না	ꯃꯆꯤꯟꯅꯥ
মচু	ꯃꯆꯨ
মচুগী	ꯃꯆꯨꯒꯤ
মচে	ꯃꯆꯦ
মচেনা	ꯃꯆꯦꯅꯥ
মচেৎ	ꯃꯆꯦꯠ
মচৈ	ꯃꯆꯩ
মজা	ꯃꯖꯥ
মণি	ꯃꯅꯤ
মণিপুর	ꯃꯅꯤꯄꯨꯔ
মণিপুরগা	ꯃꯅꯤꯄꯨꯔꯒꯥ
মণিপুরগী	ꯃꯅꯤꯄꯨꯔꯒꯤ
মণিপুরগীসু	ꯃꯅꯤꯄꯨꯔꯒꯤꯁꯨ
মণিপুরদগী	ꯃꯅꯤꯄꯨꯔꯗꯒꯤ
মণিপুরদনা	ꯃꯅꯤꯄꯨꯔꯗꯅꯥ
মণিপুরদসু	ꯃꯅꯤꯄꯨꯔꯗꯁꯨ
মণিপুরদা	ꯃꯅꯤꯄꯨꯔꯗꯥ
মণিপুরনসু	ꯃꯅꯤꯄꯨꯔꯅꯁꯨ
মণিপুরনা	ꯃꯅꯤꯄꯨꯔꯅꯥ
মণিপুরবু	ꯃꯅꯤꯄꯨꯔꯕꯨ
মণিপুরসু	ꯃꯅꯤꯄꯨꯔꯁꯨ
মণিপুরি	ꯃꯅꯤꯄꯨꯔꯤ
মণিপুরী	ꯃꯅꯤꯄꯨꯔꯤ
মণিপুরীগী	ꯃꯅꯤꯄꯨꯔꯤꯒꯤ
মণিপুরীশিং	ꯃꯅꯤꯄꯨꯔꯤꯁꯤꯡ
মণিপুরীশিংগী	ꯃꯅꯤꯄꯨꯔꯤꯁꯤꯡꯒꯤ
মণিপুরীশিংদা	ꯃꯅꯤꯄꯨꯔꯤꯁꯤꯡꯗꯥ
মণিপুরীশিংনা	ꯃꯅꯤꯄꯨꯔꯤꯁꯤꯡꯅꯥ
মণিহার	ꯃꯅꯤꯍꯥꯔ
মণিহারনা	ꯃꯅꯤꯍꯥꯔꯅꯥ
মত	ꯃꯠ
মতং	ꯃꯇꯪ
মতংদা	ꯃꯇꯪꯗꯥ
মতম	ꯃꯇꯝ
মতমগা	ꯃꯇꯝꯒꯥ
মতমগী	ꯃꯇꯝꯒꯤ
মতমদগী	ꯃꯇꯝꯗꯒꯤ
মতমদতা	ꯃꯇꯝꯗꯇꯥ
মতমদদি	ꯃꯇꯝꯗꯗꯤ
মতমদনা	ꯃꯇꯝꯗꯅꯥ
মতমদসু	ꯃꯇꯝꯗꯁꯨ
মতমদা	ꯃꯇꯝꯗꯥ
মতমদি	ꯃꯇꯝꯗꯤ
মতমদুগী	ꯃꯇꯝꯗꯨꯒꯤ
মতমদুদা	ꯃꯇꯝꯗꯨꯗꯥ
মতমনা	ꯃꯇꯝꯅꯥ
মতমনি	ꯃꯇꯝꯅꯤ
মতমশিংদা	ꯃꯇꯝꯁꯤꯡꯗꯥ
মতমসি	ꯃꯇꯝꯁꯤ
মতমসিগী	ꯃꯇꯝꯁꯤꯒꯤ
মতমসিদা	ꯃꯇꯝꯁꯤꯗꯥ
মতমসু	ꯃꯇꯝꯁꯨ
মতম্নি	ꯃꯇꯝꯅꯤ
মতশিং	ꯃꯠꯁꯤꯡ
মতা	ꯃꯇꯥ
মতাং	ꯃꯇꯥꯡ
মতাংদ	ꯃꯇꯥꯡꯗ
মতাংদদি	ꯃꯇꯥꯡꯗꯗꯤ
মতাংদনি	ꯃꯇꯥꯡꯗꯅꯤ
মতাংদসু	ꯃꯇꯥꯡꯗꯁꯨ
মতাংদা	ꯃꯇꯥꯡꯗꯥ
মতাংদুদা	ꯃꯇꯥꯪꯗꯨꯗꯥ
মতাংনা	ꯃꯇꯥꯡꯅꯥ
মতাংশিং	ꯃꯇꯥꯪꯁꯤꯪ
মতাই	ꯃꯇꯥꯏ
মতাও	ꯃꯇꯥꯑꯣ
মতাঙদসু	ꯃꯇꯥꯉꯗꯁꯨ
মতাঙদা	ꯃꯇꯥꯉꯗꯥ
মতাশিং	ꯃꯇꯥꯁꯤꯡ
মতাশিংদা	ꯃꯇꯥꯁꯤꯡꯗꯥ
মতাশিংনা	ꯃꯇꯥꯁꯤꯡꯅꯥ
মতি	ꯃꯇꯤ
মতিং	ꯃꯇꯤꯡ
মতিক	ꯃꯇꯤꯛ
মতিকচাবা	ꯃꯇꯤꯛꯆꯥꯕꯥ
মতীক	ꯃꯇꯤꯀ
মতু	ꯃꯇꯨ
মতুং	ꯃꯇꯨꯡ
মতুংইন্নদি	ꯃꯇꯨꯡꯏꯟꯅꯗꯤ
মতুংইন্ননি	ꯃꯇꯨꯡꯏꯟꯅꯅꯤ
মতুংইন্নসু	ꯃꯇꯨꯡꯏꯟꯅꯁꯨ
মতুংইন্না	ꯃꯇꯨꯡꯏꯟꯅꯥ
মতুংগী	ꯃꯇꯨꯡꯒꯤ
মতুংদ	ꯃꯇꯨꯡꯗ
মতুংদগী	ꯃꯇꯨꯡꯗꯒꯤ
মতুংদগীদি	ꯃꯇꯨꯡꯗꯒꯤꯗꯤ
মতুংদদি	ꯃꯇꯨꯡꯗꯗꯤ
মতুংদসু	ꯃꯇꯨꯡꯗꯁꯨ
মতুংদা	ꯃꯇꯨꯨꯡꯗꯥ
মতুপ	ꯃꯇꯨꯄ
মতুম	ꯃꯇꯨꯝ
মতেং	ꯃꯇꯦꯡ
মতেংগা	ꯃꯇꯦꯡꯒꯥ
মতেংদগী	ꯃꯇꯦꯡꯗꯒꯤ
মতেংননি	ꯃꯇꯦꯡꯅꯅꯤ
মতেংনা	ꯃꯇꯦꯡꯅꯥ
মতেংশিং	ꯃꯇꯦꯡꯁꯤꯡ
মতেংসু	ꯃꯇꯦꯡꯁꯨ
মতেক	ꯃꯇꯦꯛ
মতৈ	ꯃꯇꯩ
মথং	ꯃꯊꯪ
মথংগী	ꯃꯊꯪꯒꯤ
মথংদনা	ꯃꯊꯪꯗꯅꯥ
মথংদা	ꯃꯊꯪꯗꯥ
মথংশিৎনা	ꯃꯊꯪꯁꯤꯠꯅꯥ
মথক	ꯃꯊꯛ
মথক্কী	ꯃꯊꯛꯀꯤ
মথঙ	ꯃꯊꯡ
মথন্তগী	ꯃꯊꯟꯇꯒꯤ
মথন্তনা	ꯃꯊꯟꯇꯅꯥ
মথন্তনি	ꯃꯊꯟꯇꯅꯤ
মথন্তা	ꯃꯊꯟꯇꯥ
মথা	ꯃꯊꯥ
মথাং	ꯃꯊꯥꯡ
মথুম	ꯃꯊꯨꯝ
মথুমনা	ꯃꯊꯨꯝꯅꯥ
মথুমশিং	ꯃꯊꯨꯝꯁꯤꯡ
মথেল	ꯃꯊꯦꯜ
মথ্বায়	ꯃꯊꯋꯥꯏ
মথৱায়	ꯃꯊꯋꯥꯌ
মদ	ꯃꯗ
মদু	ꯃꯗꯨ
মদুগা	ꯃꯗꯨꯒꯥ
মদুগী	ꯃꯗꯨꯒꯤ
মদুগীদমক	ꯃꯗꯨꯒꯤꯗꯃꯛ
মদুতদা	ꯃꯗꯨꯇꯗꯥ
মদুদগী	ꯃꯗꯨꯗꯒꯤ
মদুদসু	ꯃꯗꯨꯗꯁꯨ
মদুদা	ꯃꯗꯨꯗꯥ
মদুদি	ꯃꯗꯨꯗꯤ
মদুনা	ꯃꯗꯨꯅꯥ
মদুবু	ꯃꯗꯨꯕꯨ
মদুসু	ꯃꯗꯨꯁꯨ
মদ্রাস	ꯃꯗ꯭ꯔꯥꯁ
মদ্রাসনা	ꯃꯗ꯭ꯔꯥꯁꯅꯥ
মদ্রাসা	ꯃꯗ꯭ꯔꯥꯁꯥ
মধুমতি	ꯃꯙꯨꯃꯇꯤ
মনংুদা	ꯃꯅꯨꯡꯗꯥ
মনপ্রিত	ꯃꯟꯞꯔꯤꯠ
মনম	ꯃꯅꯝ
মনা	ꯃꯅꯥ
মনাই	ꯃꯅꯥꯏ
মনাইগী	ꯃꯅꯥꯏꯒꯤ
মনাইশিংনা	ꯃꯅꯥꯏꯁꯤꯪꯅꯥ
মনাও	ꯃꯅꯥꯎ
মনাওনা	ꯃꯅꯥꯑꯣꯅꯥ
মনাওনি	ꯃꯅꯥꯑꯣꯅꯤ
মনাওনুপা	ꯃꯅꯥꯑꯣꯅꯨꯄꯥ
মনাওশিং	ꯃꯅꯥꯎꯁꯤꯡ
মনাওসু	ꯃꯅꯥꯑꯣꯁꯨ
মনাক	ꯃꯅꯥꯛ
মনাক্কী	ꯃꯅꯥꯛꯀꯤ
মনাগী	ꯃꯅꯥꯒꯤ
মনাদা	ꯃꯅꯥꯗꯥ
মনানা	ꯃꯅꯥꯅꯥ
মনানি	ꯃꯅꯥꯅꯤ
মনাশিং	ꯃꯅꯥꯁꯤꯡ
মনাসু	ꯃꯅꯥꯁꯨ
মনি	ꯃꯅꯤ
মনিং	ꯃꯅꯤꯡ
মনিংতম্বা	ꯃꯅꯤꯡꯇꯝꯕꯥ
মনিংদা	ꯃꯅꯤꯡꯗꯥ
মনিক	ꯃꯅꯤꯀ
মনিকা	ꯃꯅꯤꯀꯥ
মনিপুর	ꯃꯅꯤꯄꯨꯔ
মনিপুরগী	ꯃꯅꯤꯄꯨꯔꯒꯤ
মনিপুরদসু	ꯃꯅꯤꯄꯨꯔꯗꯁꯨ
মনিপুরদা	ꯃꯅꯤꯄꯨꯔꯗꯥ
মনিপুরনা	ꯃꯅꯤꯄꯨꯔꯅꯥ
মনিল	ꯃꯅꯤꯜ
মনিস	ꯃꯅꯤꯁ
মনিহার	ꯃꯅꯤꯍꯥꯔ
মনীং	ꯃꯅꯤꯡ
মনীংতম্না	ꯃꯅꯤꯪꯇꯝꯅꯥ
মনীংদা	ꯃꯅꯤꯪꯗꯥ
মনুং	ꯃꯅꯨꯡ
মনুংগা	ꯃꯅꯨꯡꯒꯥ
মনুংগী	ꯃꯅꯨꯡꯒꯤ
মনুংচনবা	ꯃꯅꯨꯪꯆꯟꯕꯥ
মনুংচন্না	ꯃꯅꯨꯡꯆꯟꯅꯥ
মনুংদ	ꯃꯅꯨꯪꯗ
মনুংদগী	ꯃꯅꯨꯪꯗꯒꯤ
মনুংদতা	ꯃꯅꯨꯪꯗꯇꯥ
মনুংদদি	ꯃꯅꯨꯪꯗꯗꯤ
মনুংদনা	ꯃꯅꯨꯪꯗꯅꯥ
মনুংদনি	ꯃꯅꯨꯪꯗꯅꯤ
মনুংদসু	ꯃꯅꯨꯪꯗꯁꯨ
মনুংদা	ꯃꯅꯨꯪꯗꯥ
মনুংনা	ꯃꯅꯨꯪꯅꯥ
মনুংসিদসু	ꯃꯅꯨꯪꯁꯤꯗꯁꯨ
মনুংসিদা	ꯃꯅꯨꯪꯁꯤꯗꯥ
মন্থলি	ꯃꯟꯊꯂꯤ
মন্দল	ꯃꯟꯗꯜ
মন্দলগী	ꯃꯟꯗꯜꯒꯤ
মন্দলে	ꯃꯟꯗꯂꯦ
মন্দা	ꯃꯟꯗꯥ
মন্দিপ	ꯃꯟꯗꯤꯞ
মন্দির	ꯃꯟꯗꯤꯔ
মন্দিরগী	ꯃꯟꯗꯤꯔꯒꯤ
মন্দিরদা	ꯃꯟꯗꯤꯔꯗꯥ
মপল	ꯃꯄꯜ
মপা	ꯃꯄꯥ
মপাং	ꯃꯄꯥꯡ
মপাংগী	ꯃꯄꯥꯪꯒꯤ
মপাংশিংগী	ꯃꯄꯥꯡꯁꯤꯡꯒꯤ
মপাংশিংনা	ꯃꯄꯥꯡꯁꯤꯡꯅꯥ
মপাগী	ꯃꯄꯥꯒꯤ
মপাঙ্গল	ꯃꯄꯥꯡꯒꯜ
মপাদা	ꯃꯄꯥꯗꯥ
মপাদি	ꯃꯄꯥꯗꯤ
মপান	ꯃꯄꯥꯟ
মপানগী	ꯃꯄꯥꯟꯒꯤ
মপানদগী	ꯃꯄꯥꯟꯗꯒꯤ
মপানদা	ꯃꯄꯥꯟꯗꯥ
মপানদি	ꯃꯄꯥꯅꯗꯤ
মপানা	ꯃꯄꯥꯅꯥ
মপানি	ꯃꯄꯥꯅꯤ
মপান্দগী	ꯃꯄꯥꯟꯗꯒꯤ
মপান্দগীনি	ꯃꯄꯥꯟꯗꯒꯤꯅꯤ
মপান্দা	ꯃꯄꯥꯟꯗꯥ
মপান্ননি	ꯃꯄꯥꯟꯅꯅꯤ
মপান্না	ꯃꯄꯥꯟꯅꯥ
মপাবু	ꯃꯄꯥꯕꯨ
মপাম	ꯃꯄꯥꯝ
মপারি	ꯃꯄꯥꯔꯤ
মপাল	ꯃꯄꯥꯜ
মপালগী	ꯃꯄꯥꯜꯒꯤ
মপালদা	ꯃꯄꯥꯜꯗꯥ
মপাশিং	ꯃꯄꯥꯁꯤꯡ
মপাশিংগা	ꯃꯄꯥꯁꯤꯡꯒꯥ
মপাশিংগী	ꯃꯄꯥꯁꯤꯡꯒꯤ
মপাশিংনা	ꯃꯄꯥꯁꯤꯡꯅꯥ
মপি	ꯃꯄꯤ
মপিথেল	ꯃꯄꯤꯊꯦꯜ
মপী	ꯃꯄꯤ
মপু	ꯃꯄꯨ
মপুং	ꯃꯄꯨꯡ
মপুংওইবা	ꯃꯄꯨꯡꯑꯣꯏꯕꯥ
মপুংফানা	ꯃꯄꯨꯪꯐꯥꯅꯥ
মপুংফাবা	ꯃꯄꯨꯪꯐꯥꯕꯥ
মপুক	ꯃꯄꯨꯀ
মপুগী	ꯃꯄꯨꯒꯤ
মপুঙ	ꯃꯄꯨꯉ
মপুদা	ꯃꯄꯨꯗꯥ
মপুনা	ꯃꯄꯨꯅꯥ
মপুনি	ꯃꯄꯨꯅꯤ
মপুন্সি	ꯃꯄꯨꯟꯁꯤ
মপুবু	ꯃꯄꯨꯕꯨ
মপুম	ꯃꯄꯨꯝ
মপুশিং	ꯃꯄꯨꯁꯤꯡ
মপুশিংনা	ꯃꯄꯨꯁꯤꯡꯅꯥ
মপূক্নিংদা	ꯃꯄꯨꯛꯅꯤꯪꯗꯥ
মপৈ	ꯃꯄꯩ
মফম	ꯃꯐꯝ
মফমগী	ꯃꯐꯝꯒꯤ
মফমদ	ꯃꯐꯝꯗ
মফমদগী	ꯃꯐꯝꯗꯒꯤ
মফমদদি	ꯃꯐꯝꯗꯗꯤ
মফমদসু	ꯃꯐꯝꯗꯁꯨ
মফমদা	ꯃꯐꯝꯗꯥ
মফমদি	ꯃꯐꯝꯗꯤ
মফমদু	ꯃꯐꯝꯗꯨ
মফমদুগী	ꯃꯐꯝꯗꯨꯒꯤ
মফমদুদগী	ꯃꯐꯝꯗꯨꯗꯒꯤ
মফমদুদসু	ꯃꯐꯝꯗꯨꯗꯁꯨ
মফমদুদা	ꯃꯐꯝꯗꯨꯗꯥ
মফমনা	ꯃꯐꯝꯅꯥ
মফমনি	ꯃꯐꯝꯅꯤ
মফমশিং	ꯃꯐꯝꯁꯤꯡ
মফমশিংগী	ꯃꯐꯝꯁꯤꯡꯒꯤ
মফমশিংদগী	ꯃꯐꯝꯁꯤꯡꯗꯒꯤ
মফমশিংদদি	ꯃꯐꯝꯁꯤꯡꯗꯗꯤ
মফমশিংদসু	ꯃꯐꯝꯁꯤꯡꯗꯁꯨ
মফমশিংদা	ꯃꯐꯝꯁꯤꯡꯗꯥ
মফমশিংদি	ꯃꯐꯝꯁꯤꯡꯗꯤ
মফমশিংদুগী	ꯃꯐꯝꯁꯤꯡꯗꯨꯒꯤ
মফমশিংনি	ꯃꯐꯝꯁꯤꯡꯅꯤ
মফমশিংসু	ꯃꯐꯝꯁꯤꯡꯁꯨ
মফমসিগী	ꯃꯐꯝꯁꯤꯒꯤ
মফমসিদা	ꯃꯐꯝꯁꯤꯗꯥ
মফমসু	ꯃꯐꯝꯁꯨ
মফম্না	ꯃꯐꯝꯅꯥ
মফম্নি	ꯃꯐꯝꯅꯤ
মফি	ꯃꯐꯤ
মবুং	ꯃꯕꯨꯡ
মবুক	ꯃꯕꯨꯛ
মবুধি	ꯃꯕꯨꯙꯤ
মমতা	ꯃꯝꯇꯥ
মমল	ꯃꯃꯜ
মমলগী	ꯃꯃꯜꯒꯤ
মমলদগী	ꯃꯃꯜꯗꯒꯤ
মমলদা	ꯃꯃꯜꯗꯥ
মমলনা	ꯃꯃꯜꯅꯥ
মমলসু	ꯃꯃꯜꯁꯨ
মমা	ꯃꯃꯥ
মমাং	ꯃꯃꯥꯪ
মমাংগী	ꯃꯃꯥꯪꯒꯤ
মমাংঙৈদা	ꯃꯃꯥꯡꯉꯩꯗꯥ
মমাংদগী	ꯃꯃꯥꯡꯗꯒꯤ
মমাংদদি	ꯃꯃꯥꯡꯗꯗꯤ
মমাংদসু	ꯃꯃꯥꯡꯗꯁꯨ
মমাংদা	ꯃꯃꯥꯡꯗꯥ
মমাক	ꯃꯃꯥꯀ
মমাগা	ꯃꯃꯥꯒꯥ
মমাগী	ꯃꯃꯥꯒꯤ
মমাঙ	ꯃꯃꯥꯉ
মমাঙদগী	ꯃꯃꯥꯉꯗꯒꯤ
মমাঙদা	ꯃꯃꯥꯉꯗꯥ
মমাদা	ꯃꯃꯥꯗꯥ
মমান	ꯃꯃꯥꯅ
মমানা	ꯃꯃꯥꯅꯥ
মমান্নবশিংগা	ꯃꯃꯥꯟꯅꯕꯁꯤꯪꯒꯥ
মমান্নবশিংনা	ꯃꯃꯥꯟꯅꯕꯁꯤꯪꯅꯥ
মমান্নবা	ꯃꯃꯥꯟꯅꯕꯥ
মমান্নবী	ꯃꯃꯥꯟꯅꯕꯤ
মমাশিংনা	ꯃꯃꯥꯁꯤꯡꯅꯥ
মমায়	ꯃꯃꯥꯏ
মমি	ꯃꯃꯤ
মমিং	ꯃꯃꯤꯡ
মমিংতগী	ꯃꯃꯤꯡꯇꯒꯤ
মমিংতা	ꯃꯃꯤꯪꯇꯥ
মমিংদা	ꯃꯃꯤꯡꯗꯥ
মমিঙ	ꯃꯃꯤꯉ
মমিত্তা	ꯃꯃꯤꯠꯇꯥ
মমী	ꯃꯃꯤ
মমীং	ꯃꯃꯤꯡ
মমুৎ	ꯃꯃꯨꯠ
মমূৎ	ꯃꯃꯨꯠ
মমেন	ꯃꯃꯦꯅ
মমৈ	ꯃꯃꯩ
মমৈথংদদি	ꯃꯃꯩꯊꯪꯗꯗꯤ
মমৈথংদা	ꯃꯃꯩꯊꯪꯗꯥ
মমৈদদি	ꯃꯃꯩꯗꯗꯤ
মমৈদা	ꯃꯃꯩꯗꯥ
মরক	ꯃꯔꯛ
মরকসিদা	ꯃꯔꯛꯁꯤꯗꯥ
মরক্কি	ꯃꯔꯛꯀꯤ
মরক্কী	ꯃꯔꯛꯀꯤ
মরম	ꯃꯔꯝ
মরমগী	ꯃꯔꯝꯒꯤ
মরমগীদমক	ꯃꯔꯝꯒꯤꯗꯃꯛ
মরমদগী	ꯃꯔꯝꯗꯒꯤ
মরমদম	ꯃꯔꯝꯗꯝ
মরমদমবু	ꯃꯔꯝꯗꯝꯕꯨ
মরমদসু	ꯃꯔꯝꯗꯁꯨ
মরমদা	ꯃꯔꯝꯗꯥ
মরমদি	ꯃꯔꯝꯗꯤ
মরমনা	ꯃꯔꯝꯅꯥ
মরমশিং	ꯃꯔꯝꯁꯤꯡ
মরমসু	ꯃꯔꯝꯁꯨ
মরম্না	ꯃꯔꯝꯅꯥ
মরল	ꯃꯔꯜ
মরা	ꯃꯔꯥ
মরাং	ꯃꯔꯥꯡ
মরাংবা	ꯃꯔꯥꯪꯕꯥ
মরাই	ꯃꯔꯥꯏ
মরাইবক	ꯃꯔꯥꯏꯕꯛ
মরাইবক্না	ꯃꯔꯥꯏꯕꯛꯅꯥ
মরাম	ꯃꯔꯥꯝ
মরামগী	ꯃꯔꯥꯝꯒꯤ
মরামদা	ꯃꯔꯥꯝꯗꯥ
মরাল	ꯃꯔꯥꯜ
মরালদা	ꯃꯔꯥꯜꯗꯥ
মরালশিং	ꯃꯔꯥꯜꯁꯤꯡ
মরি	ꯃꯔꯤ
মরিং	ꯃꯔꯤꯡ
মরিংগী	ꯃꯔꯤꯪꯒꯤ
মরিংজেল	ꯃꯔꯤꯪꯖꯦꯂ
মরিক	ꯃꯔꯤꯛ
মরিখক	ꯃꯔꯤꯈꯛ
মরিগা	ꯃꯔꯤꯒꯥ
মরিগী	ꯃꯔꯤꯒꯤ
মরিদগী	ꯃꯔꯤꯗꯒꯤ
মরিদা	ꯃꯔꯤꯗꯥ
মরিদি	ꯃꯔꯤꯗꯤ
মরিন	ꯃꯔꯤꯅ
মরিনা	ꯃꯔꯤꯅꯥ
মরিনি	ꯃꯔꯤꯅꯤ
মরিনিগী	ꯃꯔꯤꯅꯤꯒꯤ
মরিফু	ꯃꯔꯤꯐꯨ
মরিমক	ꯃꯔꯤꯃꯛ
মরিমক্কী	ꯃꯔꯤꯃꯛꯀꯤ
মরিরক	ꯃꯔꯤꯔꯛ
মরিরকশুবনি	ꯃꯔꯤꯔꯛꯁꯨꯕꯅꯤ
মরিরকশুবা	ꯃꯔꯤꯔꯛꯁꯨꯕꯥ
মরিল	ꯃꯔꯤꯜ
মরিশুবদা	ꯃꯔꯤꯁꯨꯕꯗꯥ
মরিশুবা	ꯃꯔꯤꯁꯨꯕꯥ
মরিসু	ꯃꯔꯤꯁꯨ
মরিয়াপন	ꯃꯔꯤꯌꯥꯄꯟ
মরী	ꯃꯔꯤ
মরীক	ꯃꯔꯤꯛ
মরীগী	ꯃꯔꯤꯒꯤ
মরীদা	ꯃꯔꯤꯗꯥ
মরীদু	ꯃꯔꯤꯗꯨ
মরীনি	ꯃꯔꯤꯅꯤ
মরীবু	ꯃꯔꯤꯕꯨ
মরীশুবা	ꯃꯔꯤꯁꯨꯕꯥ
মরীসু	ꯃꯔꯤꯁꯨ
মরু	ꯃꯔꯨ
মরুওই	ꯃꯔꯨꯑꯣꯏ
মরুওইদে	ꯃꯔꯨꯑꯣꯏꯗꯦ
মরুওইনা	ꯃꯔꯨꯑꯣꯏꯅꯥ
মরুওইবনি	ꯃꯔꯨꯑꯣꯏꯕꯅꯤ
মরুওইবা	ꯃꯔꯨꯑꯣꯏꯕꯥ
মরুওইরক্লি	ꯃꯔꯨꯑꯣꯏꯔꯛꯂꯤ
মরুওইরবা	ꯃꯔꯨꯑꯣꯏꯔꯕꯥ
মরুওইরিবদি	ꯃꯔꯨꯑꯣꯏꯔꯤꯕꯗꯤ
মরুওইরিবা	ꯃꯔꯨꯑꯣꯏꯔꯤꯕꯥ
মরুদগী	ꯃꯔꯨꯗꯒꯤ
মরুদা	ꯃꯔꯨꯗꯥ
মরুনা	ꯃꯔꯨꯅꯥ
মরুপ	ꯃꯔꯨꯞ
মরুপকী	ꯃꯔꯨꯞꯀꯤ
মরুপনি	ꯃꯔꯨꯞꯅꯤ
মরুপশিং	ꯃꯔꯨꯞꯁꯤꯡ
মরুম	ꯃꯔꯨꯝ
মরূপ	ꯃꯔꯨꯄ
মরেংবান্দা	ꯃꯔꯦꯪꯕꯥꯟꯗꯥ
মরেল	ꯃꯔꯦꯜ
মরেলদা	ꯃꯔꯦꯜꯗꯥ
মরৈ	ꯃꯔꯩ
মরৈবাক	ꯃꯔꯩꯕꯥꯛ
মরৈবাকপু	ꯃꯔꯩꯕꯥꯛꯄꯨ
মরৈবাক্কীদমক	ꯃꯔꯩꯕꯥꯛꯀꯤꯗꯃꯛ
মর্জর	ꯃꯔꯖꯔ
মলা	ꯃꯂꯥ
মলাপুরমগী	ꯃꯂꯥꯄꯨꯔꯝꯒꯤ
মল্টি	ꯃꯜꯇꯤ
মশক	ꯃꯁꯛ
মশকনি	ꯃꯁꯛꯅꯤ
মশকশিং	ꯃꯁꯛꯁꯤꯡ
মশকসু	ꯃꯁꯛꯁꯨ
মশক্নি	ꯃꯁꯛꯅꯤ
মশম	ꯃꯁꯝ
মশল	ꯃꯁꯜ
মশা	ꯃꯁꯥ
মশাগা	ꯃꯁꯥꯒꯥ
মশাগী	ꯃꯁꯥꯒꯤ
মশাগীতা	ꯃꯁꯥꯒꯤꯇꯥ
মশাদা	ꯃꯁꯥꯗꯥ
মশাদি	ꯃꯁꯥꯗꯤ
মশাদু	ꯃꯁꯥꯗꯨ
মশানা	ꯃꯁꯥꯅꯥ
মশান্নগী	ꯃꯁꯥꯟꯅꯒꯤ
মশান্নদা	ꯃꯁꯥꯟꯅꯗꯥ
মশান্নশিং	ꯃꯁꯥꯟꯅꯁꯤꯡ
মশান্নশিংগী	ꯃꯁꯥꯟꯅꯁꯤꯡꯒꯤ
মশান্নশিংদা	ꯃꯁꯥꯟꯅꯁꯤꯡꯗꯥ
মশান্নশিংদি	ꯃꯁꯥꯟꯅꯁꯤꯡꯗꯤ
মশান্না	ꯃꯁꯥꯟꯅꯥ
মশাবু	ꯃꯁꯥꯕꯨ
মশামক	ꯃꯁꯥꯃꯛ
মশামকসু	ꯃꯁꯥꯃꯛꯁꯨ
মশামক্কা	ꯃꯁꯥꯃꯛꯀꯥ
মশামক্কী	ꯃꯁꯥꯃꯛꯀꯤ
মশামক্নসু	ꯃꯁꯥꯃꯛꯅꯁꯨ
মশামক্না	ꯃꯁꯥꯃꯛꯅꯥ
মশাসু	ꯃꯁꯥꯁꯨ
মশিং	ꯃꯁꯤꯡ
মশিংগী	ꯃꯁꯤꯡꯒꯤ
মশিংদগী	ꯃꯁꯤꯡꯗꯒꯤ
মশিংদা	ꯃꯁꯤꯡꯗꯥ
মশিংদি	ꯃꯁꯤꯡꯗꯤ
মশিংনা	ꯃꯁꯤꯡꯅꯥ
মশিংসু	ꯃꯁꯤꯡꯁꯨ
মশিগী	ꯃꯁꯤꯒꯤ
মশীং	ꯃꯁꯤꯪ
মশু	ꯃꯁꯨ
মশুং	ꯃꯁꯨꯡ
মশুদা	ꯃꯁꯨꯗꯥ
মশুনা	ꯃꯁꯨꯅꯥ
মশুনুপা	ꯃꯁꯨꯅꯨꯄꯥ
মশুশিংবু	ꯃꯁꯨꯁꯤꯡꯕꯨ
মশেক	ꯃꯁꯦꯀ
মশেল	ꯃꯁꯦꯜ
মশেলগী	ꯃꯁꯦꯜꯒꯤ
মসি	ꯃꯁꯤ
মসিগা	ꯃꯁꯤꯒꯥ
মসিগী	ꯃꯁꯤꯒꯤ
মসিগীদমক	ꯃꯁꯤꯒꯤꯗꯃꯛ
মসিগুম	ꯃꯁꯤꯒꯨꯝ
মসিগুম্বা	ꯃꯁꯤꯒꯨꯝꯕꯥ
মসিদগী	ꯃꯁꯤꯗꯒꯤ
মসিদনা	ꯃꯁꯤꯗꯅꯥ
মসিদবু	ꯃꯁꯤꯗꯕꯨ
মসিদসু	ꯃꯁꯤꯗꯁꯨ
মসিদা	ꯃꯁꯤꯗꯥ
মসিদি	ꯃꯁꯤꯗꯤ
মসিনা	ꯃꯁꯤꯅꯥ
মসিনি	ꯃꯁꯤꯅꯤ
মসিবু	ꯃꯁꯤꯕꯨ
মসিমক	ꯃꯁꯤꯃꯛ
মসিমক্না	ꯃꯁꯤꯃꯛꯅꯥ
মসিসু	ꯃꯁꯤꯁꯨ
মসু	ꯃꯁꯨ
মসুং	ꯃꯁꯨꯪ
মহক্কী	ꯃꯍꯛꯀꯤ
মহক্না	ꯃꯍꯛꯅꯥ
মহল	ꯃꯍꯜ
মহা	ꯃꯍꯥ
মহাও	ꯃꯍꯥꯎ
মহাক	ꯃꯍꯥꯛ
মহাকনা	ꯃꯍꯥꯛꯅꯥ
মহাকপু	ꯃꯍꯥꯀꯄꯨ
মহাকবি	ꯃꯍꯥꯀꯕꯤ
মহাকসু	ꯃꯍꯥꯛꯁꯨ
মহাক্কা	ꯃꯍꯥꯛꯀꯥ
মহাক্কি	ꯃꯍꯥꯛꯀꯤ
মহাক্কী	ꯃꯍꯥꯛꯀꯤ
মহাক্কীনি	ꯃꯍꯥꯛꯀꯤꯅꯤ
মহাক্কুম্বা	ꯃꯍꯥꯛꯀꯨꯝꯕꯥ
মহাক্ন	ꯃꯍꯥꯛꯅ
মহাক্না	ꯃꯍꯥꯛꯅꯥ
মহাজন	ꯃꯍꯥꯖꯟ
মহাত্মা	ꯃꯍꯥꯠꯃꯥ
মহাদেব	ꯃꯍꯥꯗꯦꯕ
মহানদি	ꯃꯍꯥꯅꯗꯤ
মহাবলি	ꯃꯍꯥꯕꯂꯤ
মহারাজ	ꯃꯍꯥꯔꯥꯖ
মহারাজগী	ꯃꯍꯥꯔꯥꯖꯒꯤ
মহারানী	ꯃꯍꯥꯔꯥꯅꯤ
মহারাষ্ট্র	ꯃꯍꯥꯔꯥꯁꯇ꯭ꯔ
মহারাষ্ট্রগী	ꯃꯍꯥꯔꯥꯁꯇ꯭ꯔꯒꯤ
মহারাষ্ট্রদা	ꯃꯍꯥꯔꯥꯁꯇ꯭ꯔꯗꯥ
মহারাষ্ট্রনা	ꯃꯍꯥꯔꯥꯁꯇ꯭ꯔꯅꯥ
মহি	ꯃꯍꯤ
মহিং	ꯃꯍꯤꯡ
মহিংদা	ꯃꯍꯤꯡꯗꯥ
মহিংবু	ꯃꯍꯤꯡꯕꯨ
মহিলা	ꯃꯍꯤꯂꯥ
মহী	ꯃꯍꯤ
মহু	ꯃꯍꯨ
মহুত্তা	ꯃꯍꯨꯠꯇꯥ
মহুৎ	ꯃꯍꯨꯠ
মহুৎতা	ꯃꯍꯨꯠꯇꯥ
মহেন্দ্র	ꯃꯍꯦꯟꯗ꯭ꯔ
মহেশ্বরি	ꯃꯍꯦꯁ꯭ꯋꯔꯤ
মহেস	ꯃꯍꯦꯁ
মহৈ	ꯃꯍꯩ
মহৈগী	ꯃꯍꯩꯒꯤ
মহৈদি	ꯃꯍꯩꯗꯤ
মহৈনা	ꯃꯍꯩꯅꯥ
মহৈনি	ꯃꯍꯩꯅꯤ
মহৈবু	ꯃꯍꯩꯕꯨ
মহয়	ꯃꯍꯌ
মহয়না	ꯃꯍꯌꯅꯥ
মহয়নি	ꯃꯍꯌꯅꯤ
মহয়সু	ꯃꯍꯌꯁꯨ
মা	ꯃꯥ
মাং	ꯃꯥꯡ
মাংওইননা	ꯃꯥꯡꯑꯣꯏꯅꯅꯥ
মাংগী	ꯃꯥꯡꯒꯤ
মাংজিন	ꯃꯥꯡꯖꯤꯅ
মাংজিল	ꯃꯥꯡꯖꯤꯜ
মাংদা	ꯃꯥꯡꯗꯥ
মাংনিংঙাই	ꯃꯥꯡꯅꯤꯡꯉꯥꯏ
মাংবা	ꯃꯥꯡꯕꯥ
মাংহনবগী	ꯃꯥꯡꯍꯟꯕꯒꯤ
মাংহল্লে	ꯃꯥꯡꯍꯜꯂꯦ
মাই	ꯃꯥꯏ
মাইওন	ꯃꯥꯏꯑꯣꯟ
মাইকেল	ꯃꯥꯏꯀꯦꯜ
মাইকৈ	ꯃꯥꯏꯀꯩ
মাইকৈদগী	ꯃꯥꯏꯀꯩꯗꯒꯤ
মাইকৈদা	ꯃꯥꯏꯀꯩꯗꯥ
মাইখুম	ꯃꯥꯏꯈꯨꯝ
মাইগ্রেন্ট	ꯃꯥꯏꯒ꯭ꯔꯦꯟꯇ
মাইনর	ꯃꯥꯏꯅꯔ
মাইন্দ	ꯃꯥꯏꯟꯗ
মাইপাক	ꯃꯥꯏꯄꯥꯛ
মাইপাকসনা	ꯃꯥꯏꯄꯥꯛꯁꯅꯥ
মাইবম	ꯃꯥꯏꯕꯝ
মাইবা	ꯃꯥꯏꯕꯥ
মাইবী	ꯃꯥꯏꯕꯤ
মাইম	ꯃꯥꯏꯝ
মাইরেনবম	ꯃꯥꯏꯔꯦꯟꯕꯝ
মাইরেম্বম	ꯃꯥꯏꯔꯦꯝꯕꯝ
মাইল	ꯃꯥꯏꯜ
মাইল্ড	ꯃꯥꯏꯜꯗ
মাইস্নাম	ꯃꯥꯏꯁꯅꯥꯝ
মাও	ꯃꯥꯑꯣ
মাওদা	ꯃꯥꯑꯣꯗꯥ
মাক্স	ꯃꯥꯛꯁ
মাগা	ꯃꯥꯒꯥ
মাগী	ꯃꯥꯒꯤ
মাগীনি	ꯃꯥꯒꯤꯅꯤ
মাঙ	ꯃꯥꯡ
মাঙখি	ꯃꯥꯡꯈꯤ
মাঙখিবা	ꯃꯥꯡꯈꯤꯕꯥ
মাঙখ্রে	ꯃꯥꯡꯈꯔꯦ
মাঙজিল	ꯃꯥꯉꯖꯤꯂ
মাঙনবা	ꯃꯥꯉꯟꯕꯥ
মাঙহন	ꯃꯥꯡꯍꯟ
মাঙহনখি	ꯃꯥꯡꯍꯟꯈꯤ
মাঙহনখিনবা	ꯃꯥꯡꯍꯟꯈꯤꯅꯕꯥ
মাঙহনখিবনি	ꯃꯥꯡꯍꯟꯈꯤꯕꯅꯤ
মাঙহনখ্রে	ꯃꯥꯡꯍꯟꯈꯔꯦ
মাঙহনবগী	ꯃꯥꯡꯍꯟꯕꯒꯤ
মাঙহনবা	ꯃꯥꯡꯍꯟꯕꯥ
মাঙহনবীখ্রে	ꯃꯥꯉꯍꯟꯕꯤꯈꯔꯦ
মাঙহন্দনা	ꯃꯥꯡꯍꯟꯗꯅꯥ
মাঙহল্লে	ꯃꯥꯡꯍꯜꯂꯦ
মাচ	ꯃꯥꯆ
মাদর	ꯃꯥꯗꯔ
মাদ্রাসা	ꯃꯥꯗ꯭ꯔꯥꯁꯥ
মাদ্রাসাদা	ꯃꯥꯗ꯭ꯔꯥꯁꯥꯗꯥ
মাধব	ꯃꯥꯙꯕ
মান	ꯃꯥꯟ
মানবা	ꯃꯥꯟꯕꯥ
মানবী	ꯃꯥꯟꯕꯤ
মানসু	ꯃꯥꯅꯁꯨ
মানা	ꯃꯥꯅꯥ
মানি	ꯃꯥꯅꯤ
মানু	ꯃꯥꯅꯨ
মান্দপ	ꯃꯥꯟꯗꯞ
মান্দপতা	ꯃꯥꯟꯗꯞꯇꯥ
মান্দব	ꯃꯥꯟꯗꯕ
মান্দবা	ꯃꯥꯟꯗꯕꯥ
মান্দা	ꯃꯥꯟꯗꯥ
মান্দে	ꯃꯥꯟꯗꯦ
মান্দ্রে	ꯃꯥꯟꯗꯔꯦ
মান্নদবগী	ꯃꯥꯟꯅꯗꯕꯒꯤ
মান্নদবা	ꯃꯥꯟꯅꯗꯕꯥ
মান্নদে	ꯃꯥꯟꯅꯗꯦ
মান্ননবা	ꯃꯥꯟꯅꯅꯕꯥ
মান্ননা	ꯃꯥꯟꯅꯅꯥ
মান্নবা	ꯃꯥꯟꯅꯕꯥ
মান্নরবা	ꯃꯥꯟꯅꯔꯕꯥ
মান্নরে	ꯃꯥꯟꯅꯔꯦ
মান্নহন্নবা	ꯃꯥꯟꯅꯍꯟꯅꯕꯥ
মান্না	ꯃꯥꯟꯅꯥ
মান্নুং	ꯃꯥꯟꯅꯨꯪ
মান্নৈ	ꯃꯥꯟꯅꯩ
মাপন	ꯃꯥꯄꯟ
মাবু	ꯃꯥꯕꯨ
মাবুসু	ꯃꯥꯕꯨꯁꯨ
মাম্মা	ꯃꯥꯝꯃꯥ
মার	ꯃꯥꯔ
মারজিৎ	ꯃꯥꯔꯖꯤꯠ
মারনা	ꯃꯥꯔꯅꯥ
মারিস	ꯃꯥꯔꯤꯁ
মারুতি	ꯃꯥꯔꯨꯇꯤ
মার্ক	ꯃꯥꯔꯛ
মার্ককী	ꯃꯥꯔꯛꯀꯤ
মার্কতা	ꯃꯥꯔꯛꯇꯥ
মার্কনা	ꯃꯥꯔꯛꯅꯥ
মার্কেটতা	ꯃꯥꯔꯀꯦꯠꯇꯥ
মার্কেটসু	ꯃꯥꯔꯀꯦꯠꯁꯨ
মার্কেটিং	ꯃꯥꯔꯀꯦꯇꯤꯡ
মার্কেল	ꯃꯥꯔꯀꯦꯜ
মার্গ	ꯃꯥꯔꯒ
মার্গতা	ꯃꯥꯔꯒꯇꯥ
মার্চ	ꯃꯥꯔꯆ
মার্চকী	ꯃꯥꯔꯆꯀꯤ
মার্চতগী	ꯃꯥꯔꯆꯠꯒꯤ
মার্জিট	ꯃꯥꯔꯖꯤꯇ
মার্জিনেল	ꯃꯥꯔꯖꯤꯅꯦꯜ
মার্সেল	ꯃꯥꯔꯁꯦꯜ
মাল	ꯃꯥꯜ
মালংদা	ꯃꯥꯂꯪꯗꯥ
মালা	ꯃꯥꯂꯥ
মালেম	ꯃꯥꯂꯦꯝ
মালেমগা	ꯃꯥꯂꯦꯝꯒꯥ
মালেমগী	ꯃꯥꯂꯦꯝꯒꯤ
মালেমদগী	ꯃꯥꯂꯦꯝꯗꯒꯤ
মালেমদা	ꯃꯥꯂꯦꯝꯗꯥ
মালেমনা	ꯃꯥꯂꯦꯝꯅꯥ
মালেমবু	ꯃꯥꯂꯦꯝꯕꯨ
মালেমসিদা	ꯃꯥꯂꯦꯝꯁꯤꯗꯥ
মালেম্না	ꯃꯥꯂꯦꯝꯅꯥ
মালেসিয়াগী	ꯃꯥꯂꯦꯁꯤꯌꯥꯒꯤ
মাল্লবা	ꯃꯥꯜꯂꯕꯥ
মাল্লি	ꯃꯥꯜꯂꯤ
মাল্লী	ꯃꯥꯜꯂꯤ
মাল্লে	ꯃꯥꯜꯂꯦ
মাষ্টর	ꯃꯥꯁꯇꯔ
মাষ্টরদা	ꯃꯥꯁꯇꯔꯗꯥ
মাস	ꯃꯥꯁ
মাসু	ꯃꯥꯁꯨ
মাস্ক	ꯃꯥꯁꯛ
মাস্কনচিংবা	ꯃꯥꯁꯛꯅꯆꯤꯡꯕꯥ
মায়	ꯃꯥꯌ
মায়ওন	ꯃꯥꯌꯑꯣꯟ
মায়ওনদা	ꯃꯥꯌꯑꯣꯟꯗꯥ
মায়কৈ	ꯃꯥꯏꯀꯩ
মায়কৈগী	ꯃꯥꯏꯀꯩꯒꯤ
মায়কৈদগী	ꯃꯥꯏꯀꯩꯗꯒꯤ
মায়কৈদগীসু	ꯃꯥꯏꯀꯩꯗꯒꯤꯁꯨ
মায়কৈদা	ꯃꯥꯏꯀꯩꯗꯥ
মায়খুম	ꯃꯥꯏꯈꯨꯝ
মায়থিখি	ꯃꯥꯏꯊꯤꯈꯤ
মায়থিদুনা	ꯃꯥꯏꯊꯤꯗꯨꯅꯥ
মায়থিবা	ꯃꯥꯏꯊꯤꯕꯥ
মায়পাকপী	ꯃꯥꯏꯄꯥꯛꯞꯤ
মিং	ꯃꯤꯡ
মিংচৎ	ꯃꯤꯡꯆꯠ
মিংদা	ꯃꯤꯡꯗꯥ
মিংনা	ꯃꯤꯪꯅꯥ
মিংশেল	ꯃꯤꯪꯁꯦꯂ
মিক্স	ꯃꯤꯛꯁ
মিট	ꯃꯤꯠ
মিটকী	ꯃꯤꯠꯀꯤ
মিটর	ꯃꯤꯇꯔ
মিদ	ꯃꯤꯗ
মিদল	ꯃꯤꯗꯜ
মিদিয়া	ꯃꯤꯗꯤꯌꯥ
মিদিয়াগী	ꯃꯤꯗꯤꯌꯥꯒꯤ
মিদিয়াদা	ꯃꯤꯗꯤꯌꯥꯗꯥ
মিদিয়ানা	ꯃꯤꯗꯤꯌꯥꯅꯥ
মিন	ꯃꯤꯅ
মিনট	ꯃꯤꯅꯠ
মিনর	ꯃꯤꯅꯔ
মিনানা	ꯃꯤꯅꯥꯅꯥ
মিনি	ꯃꯤꯅꯤ
মিনিট	ꯃꯤꯅꯤꯇ
মিনিটতা	ꯃꯤꯅꯤꯇꯇꯥ
মিনিষ্টর	ꯃꯤꯅꯤꯁꯇ꯭ꯔ
মিনিষ্টরগী	ꯃꯤꯅꯤꯁꯇ꯭ꯔꯒꯤ
মিনিষ্টরনা	ꯃꯤꯅꯤꯁꯇ꯭ꯔꯅꯥ
মিনিষ্ট্রি	ꯃꯤꯅꯤꯁꯇ꯭ꯔꯤ
মিনিষ্ট্রিদা	ꯃꯤꯅꯤꯁꯇ꯭ꯔꯤꯗꯥ
মিনিষ্ট্রিনা	ꯃꯤꯅꯤꯁꯇ꯭ꯔꯤꯅꯥ
মিনুংশি	ꯃꯤꯅꯨꯪꯁꯤ
মিপাইনবা	ꯃꯤꯄꯥꯏꯟꯕꯥ
মিরজানা	ꯃꯤꯔꯖꯥꯅꯥ
মিরজাপুর	ꯃꯤꯔꯖꯥꯄꯨꯔ
মিরজাপুরগী	ꯃꯤꯔꯖꯥꯄꯨꯔꯒꯤ
মিরাবাই	ꯃꯤꯔꯥꯕꯥꯏ
মিল	ꯃꯤꯜ
মিলন	ꯃꯤꯂꯟ
মিলাদ	ꯃꯤꯂꯥꯗ
মিলিটরি	ꯃꯤꯂꯤꯇꯔꯤ
মিলিটেন্ট	ꯃꯤꯂꯤꯇꯦꯟꯇ
মিলিটেন্টশিং	ꯃꯤꯂꯤꯇꯦꯟꯇꯁꯤꯪ
মিলিয়ন	ꯃꯤꯂꯤꯌꯅ
মিল্লিয়ন	ꯃꯤꯜꯂꯤꯌꯅ
মিশ্রা	ꯃꯤꯁꯔꯥ
মিশ্রানা	ꯃꯤꯁ꯭ꯔꯥꯅꯥ
মিষ্টর	ꯃꯤꯁꯇꯔ
মিস	ꯃꯤꯁ
মিসন	ꯃꯤꯁꯟ
মিসনগী	ꯃꯤꯁꯟꯒꯤ
মিসনদা	ꯃꯤꯁꯟꯗꯥ
মিসননা	ꯃꯤꯁꯟꯅꯥ
মিসন্না	ꯃꯤꯁꯟꯅꯥ
মিসাইল	ꯃꯤꯁꯥꯏꯜ
মিসাইলগী	ꯃꯤꯁꯥꯏꯜꯒꯤ
মিৎ	ꯃꯤꯠ
মিৎনা	ꯃꯤꯠꯅꯥ
মিৎয়েং	ꯃꯤꯠꯌꯦꯡ
মিয়া	ꯃꯤꯌꯥ
মী	ꯃꯤ
মীং	ꯃꯤꯡ
মীংচৎ	ꯃꯤꯡꯆꯠ
মীংদা	ꯃꯤꯡꯗꯥ
মীওই	ꯃꯤꯑꯣꯏ
মীওইগী	ꯃꯤꯑꯣꯏꯒꯤ
মীওইদগী	ꯃꯤꯑꯣꯏꯗꯒꯤ
মীওইদা	ꯃꯤꯑꯣꯏꯗꯥ
মীওইনা	ꯃꯤꯑꯣꯏꯅꯥ
মীওইনি	ꯃꯤꯑꯣꯏꯅꯤ
মীওইবগা	ꯃꯤꯑꯣꯏꯕꯒꯥ
মীওইবগী	ꯃꯤꯑꯣꯏꯕꯒꯤ
মীওইবদা	ꯃꯤꯑꯣꯏꯕꯗꯥ
মীওইবনা	ꯃꯤꯑꯣꯏꯕꯅꯥ
মীওইববু	ꯃꯤꯑꯣꯏꯕꯕꯨ
মীওইবা	ꯃꯤꯑꯣꯏꯕꯥ
মীওইশিং	ꯃꯤꯑꯣꯏꯁꯤꯡ
মীওইশিংগসু	ꯃꯤꯑꯣꯏꯁꯤꯡꯒꯁꯨ
মীওইশিংগা	ꯃꯤꯑꯣꯏꯁꯤꯡꯒꯥ
মীওইশিংগী	ꯃꯤꯑꯣꯏꯁꯤꯡꯒꯤ
মীওইশিংগীদমক	ꯃꯤꯑꯣꯏꯁꯤꯡꯒꯤꯗꯃꯛ
মীওইশিংদগী	ꯃꯤꯑꯣꯏꯁꯤꯡꯗꯒꯤ
মীওইশিংদদি	ꯃꯤꯑꯣꯏꯁꯤꯡꯗꯗꯤ
মীওইশিংদনা	ꯃꯤꯑꯣꯏꯁꯤꯡꯗꯅꯥ
মীওইশিংদসু	ꯃꯤꯑꯣꯏꯁꯤꯡꯗꯁꯨ
মীওইশিংদা	ꯃꯤꯑꯣꯏꯁꯤꯡꯗꯥ
মীওইশিংদি	ꯃꯤꯑꯣꯏꯁꯤꯡꯗꯤ
মীওইশিংদু	ꯃꯤꯑꯣꯏꯁꯤꯡꯗꯨ
মীওইশিংনচিংবা	ꯃꯤꯑꯣꯏꯁꯤꯡꯅꯆꯤꯡꯕꯥ
মীওইশিংনসু	ꯃꯤꯑꯣꯏꯁꯤꯡꯅꯁꯨ
মীওইশিংনা	ꯃꯤꯑꯣꯏꯁꯤꯡꯅꯥ
মীওইশিংনি	ꯃꯤꯑꯣꯏꯁꯤꯡꯅꯤ
মীওইশিংবু	ꯃꯤꯑꯣꯏꯁꯤꯡꯕꯨ
মীওইশিংবুসু	ꯃꯤꯑꯣꯏꯁꯤꯡꯕꯨꯁꯨ
মীওইশিংসু	ꯃꯤꯑꯣꯏꯁꯤꯡꯁꯨ
মীওশিং	ꯃꯤꯑꯣꯁꯤꯡ
মীওৎ	ꯃꯤꯑꯣꯠ
মীকপ	ꯃꯤꯀꯞ
মীকুপ	ꯃꯤꯀꯨꯞ
মীকুপনি	ꯃꯤꯀꯨꯞꯅꯤ
মীখল	ꯃꯤꯈꯜ
মীখলগা	ꯃꯤꯈꯜꯒꯥ
মীখলগী	ꯃꯤꯈꯜꯒꯤ
মীখলগীদমক	ꯃꯤꯈꯜꯒꯤꯗꯃꯛ
মীখলগীনা	ꯃꯤꯈꯜꯒꯤꯅꯥ
মীখলদসু	ꯃꯤꯈꯜꯗꯁꯨ
মীখলদা	ꯃꯤꯈꯜꯗꯥ
মীখলনা	ꯃꯤꯈꯜꯅꯥ
মীখলনি	ꯃꯤꯈꯜꯅꯤ
মীখলশিং	ꯃꯤꯈꯜꯁꯤꯡ
মীখলসিদা	ꯃꯤꯈꯜꯁꯤꯗꯥ
মীখাই	ꯃꯤꯈꯥꯏ
মীখায়	ꯃꯤꯈꯥꯌ
মীগগী	ꯃꯤꯒꯒꯤ
মীগা	ꯃꯤꯒꯥ
মীগী	ꯃꯤꯒꯤ
মীচং	ꯃꯤꯆꯡ
মীচম	ꯃꯤꯆꯝ
মীচমশিংগী	ꯃꯤꯆꯝꯁꯤꯡꯒꯤ
মীচৈ	ꯃꯤꯆꯩ
মীট	ꯃꯤꯇ
মীতম	ꯃꯤꯇꯝ
মীতিন	ꯃꯤꯇꯤꯅꯟ
মীতৈ	ꯃꯤꯇꯩ
মীতৈগী	ꯃꯤꯇꯩꯒꯤ
মীতৈনা	ꯃꯤꯇꯩꯅꯥ
মীতৈবু	ꯃꯤꯇꯩꯕꯨ
মীতৈবুসু	ꯃꯤꯇꯩꯕꯨꯁꯨ
মীতৈশিংগী	ꯃꯤꯇꯩꯁꯤꯡꯒꯤ
মীতৈশিংবু	ꯃꯤꯇꯩꯁꯤꯡꯕꯨ
মীথুং	ꯃꯤꯊꯨꯡ
মীথুন	ꯃꯤꯊꯨꯟ
মীদি	ꯃꯤꯗꯤ
মীদুনা	ꯃꯤꯗꯨꯅꯥ
মীনম	ꯃꯤꯅꯝ
মীনম্বা	ꯃꯤꯅꯝꯕꯥ
মীনা	ꯃꯤꯅꯥ
মীনাই	ꯃꯤꯅꯥꯏ
মীনাইনা	ꯃꯤꯅꯥꯏꯅꯥ
মীনাগী	ꯃꯤꯅꯥꯒꯤ
মীনানা	ꯃꯤꯅꯥꯅꯥ
মীনি	ꯃꯤꯅꯤ
মীনুংশি	ꯃꯤꯅꯨꯡꯁꯤ
মীনুংশিংগী	ꯃꯤꯅꯨꯡꯁꯤꯡꯒꯤ
মীনুংশিগা	ꯃꯤꯅꯨꯡꯁꯤꯒꯥ
মীনুংশিগী	ꯃꯤꯅꯨꯡꯁꯤꯒꯤ
মীনৈ	ꯃꯤꯅꯩ
মীনৈগী	ꯃꯤꯅꯩꯒꯤ
মীপাইনবা	ꯃꯤꯄꯥꯏꯅꯕꯥ
মীপাইনরিবা	ꯃꯤꯄꯥꯏꯅꯔꯤꯕꯥ
মীপাইনিংঙাই	ꯃꯤꯄꯥꯏꯅꯤꯡꯉꯥꯏ
মীপাইবা	ꯃꯤꯄꯥꯏꯕꯥ
মীপান	ꯃꯤꯄꯥꯟ
মীপাল	ꯃꯤꯄꯥꯜ
মীপায়নিংঙাই	ꯃꯤꯄꯥꯏꯅꯤꯡꯉꯥꯏ
মীপায়বা	ꯃꯤꯄꯥꯏꯕꯥ
মীপুং	ꯃꯤꯄꯨꯪ
মীপুন	ꯃꯤꯄꯨꯟ
মীপুনগী	ꯃꯤꯄꯨꯟꯒꯤ
মীপুম	ꯃꯤꯄꯨꯃꯝ
মীফম	ꯃꯤꯐꯝ
মীফমগী	ꯃꯤꯐꯝꯒꯤ
মীফমদগী	ꯃꯤꯐꯝꯗꯒꯤ
মীফমদসু	ꯃꯤꯐꯝꯗꯁꯨ
মীফমদা	ꯃꯤꯐꯝꯗꯥ
মীফমদি	ꯃꯤꯐꯝꯗꯤ
মীফমদুদা	ꯃꯤꯐꯝꯗꯨꯗꯥ
মীফমনা	ꯃꯤꯐꯝꯅꯥ
মীফম্না	ꯃꯤꯐꯝꯅꯥ
মীবু	ꯃꯤꯕꯨ
মীরক	ꯃꯤꯔꯛ
মীরমগী	ꯃꯤꯔꯝꯒꯤ
মীরমদগী	ꯃꯤꯔꯝꯗꯒꯤ
মীরমদা	ꯃꯤꯔꯝꯗꯥ
মীরা	ꯃꯤꯔꯥ
মীরেপ	ꯃꯤꯔꯦꯞ
মীরেপকী	ꯃꯤꯔꯦꯞꯀꯤ
মীরেপকীদমক	ꯃꯤꯔꯦꯞꯀꯤꯗꯃꯛ
মীরেপচে	ꯃꯤꯔꯦꯞꯆꯦ
মীরেপচেশিং	ꯃꯤꯔꯦꯞꯆꯦꯁꯤꯡ
মীরেপতা	ꯃꯤꯔꯦꯞꯇꯥ
মীরেপনা	ꯃꯤꯔꯦꯞꯅꯥ
মীরেপনি	ꯃꯤꯔꯦꯞꯅꯤ
মীরেপশিং	ꯃꯤꯔꯦꯞꯁꯤꯡ
মীরেপশিংগী	ꯃꯤꯔꯦꯞꯁꯤꯡꯒꯤ
মীরেপশিংগীদমক	ꯃꯤꯔꯦꯞꯁꯤꯡꯒꯤꯗꯃꯛ
মীরেপশিংদা	ꯃꯤꯔꯦꯞꯁꯤꯡꯗꯥ
মীরেপশিংদি	ꯃꯤꯔꯦꯞꯁꯤꯡꯗꯤ
মীরেপশিংনা	ꯃꯤꯔꯦꯞꯁꯤꯡꯅꯥ
মীরেপশিংবু	ꯃꯤꯔꯦꯞꯁꯤꯡꯕꯨ
মীরেপ্তা	ꯃꯤꯔꯦꯞꯇꯥ
মীরেপ্পু	ꯃꯤꯔꯦꯞꯄꯨ
মীরৈবাক	ꯃꯤꯔꯩꯕꯥꯛ
মীরৈবাক্কী	ꯃꯤꯔꯩꯕꯥꯛꯀꯤ
মীশক	ꯃꯤꯁꯛ
মীশকনি	ꯃꯤꯁꯛꯅꯤ
মীশক্নি	ꯃꯤꯁꯛꯅꯤ
মীশি	ꯃꯤꯁꯤ
মীশিং	ꯃꯤꯁꯤꯡ
মীশিংগা	ꯃꯤꯁꯤꯡꯒꯥ
মীশিংগী	ꯃꯤꯁꯤꯡꯒꯤ
মীশিংদা	ꯃꯤꯁꯤꯡꯗꯥ
মীশিংনা	ꯃꯤꯁꯤꯡꯅꯥ
মীশিংসু	ꯃꯤꯁꯤꯡꯁꯨ
মীশিগী	ꯃꯤꯁꯤꯒꯤ
মীসু	ꯃꯤꯁꯨ
মীহাৎ	ꯃꯤꯍꯥꯠ
মীহাৎকী	ꯃꯤꯍꯥꯠꯀꯤ
মীহাৎতা	ꯃꯤꯍꯥꯠꯇꯥ
মীহাৎপা	ꯃꯤꯍꯥꯠꯄꯥ
মীহুৎ	ꯃꯤꯍꯨꯠ
মীহুৎকা	ꯃꯤꯍꯨꯠꯀꯥ
মীহুৎনি	ꯃꯤꯍꯨꯠꯅꯤ
মীহুৎশিং	ꯃꯤꯍꯨꯠꯁꯤꯡ
মীহুৎশিংগা	ꯃꯤꯍꯨꯠꯁꯤꯡꯒꯥ
মীহুৎশিংগী	ꯃꯤꯍꯨꯠꯁꯤꯡꯒꯤ
মীহুৎশিংদা	ꯃꯤꯍꯨꯠꯁꯤꯡꯗꯥ
মীহুৎশিংনা	ꯃꯤꯍꯨꯠꯁꯤꯡꯅꯥ
মীহুৎশিংসু	ꯃꯤꯍꯨꯠꯁꯤꯡꯁꯨ
মীহেনবা	ꯃꯤꯍꯦꯟꯕꯥ
মীৎ	ꯃꯤꯠ
মীৎকা	ꯃꯤꯠꯀꯥ
মীৎকী	ꯃꯤꯠꯀꯤ
মীৎনা	ꯃꯤꯠꯅꯥ
মীৎয়েং	ꯃꯤꯠꯌꯦꯡ
মীৎয়েংগা	ꯃꯤꯠꯌꯦꯡꯒꯥ
মীৎয়েংগী	ꯃꯤꯠꯌꯦꯡꯒꯤ
মীৎয়েংদা	ꯃꯤꯠꯌꯦꯡꯗꯥ
মীৎয়েংনা	ꯃꯤꯠꯌꯦꯡꯅꯥ
মীৎয়েংনি	ꯃꯤꯠꯌꯦꯡꯅꯤ
মীয়াই	ꯃꯤꯌꯥꯏ
মীয়ান	ꯃꯤꯌꯥꯟ
মীয়াম	ꯃꯤꯌꯥꯝ
মীয়ামগগী	ꯃꯤꯌꯥꯝꯒꯒꯤ
মীয়ামগা	ꯃꯤꯌꯥꯝꯒꯥ
মীয়ামগী	ꯃꯤꯌꯥꯝꯒꯤ
মীয়ামগীদমক	ꯃꯤꯌꯥꯝꯒꯤꯗꯃꯛ
মীয়ামগীনি	ꯃꯤꯌꯥꯝꯒꯤꯅꯤ
মীয়ামদগী	ꯃꯤꯌꯥꯓꯝꯗꯒꯤ
মীয়ামদদি	ꯃꯤꯌꯥꯝꯗꯗꯤ
মীয়ামদসু	ꯃꯤꯌꯥꯝꯗꯁꯨ
মীয়ামদা	ꯃꯤꯌꯥꯝꯗꯥ
মীয়ামনদি	ꯃꯤꯌꯥꯝꯅꯗꯤ
মীয়ামনসু	ꯃꯤꯌꯥꯝꯅꯁꯨ
মীয়ামনা	ꯃꯤꯌꯥꯝꯅꯥ
মীয়ামবু	ꯃꯤꯌꯥꯝꯕꯨ
মীয়ামশিং	ꯃꯤꯌꯥꯝꯁꯤꯡ
মীয়ামসু	ꯃꯤꯌꯥꯝꯁꯨ
মীয়াম্নসু	ꯃꯤꯌꯥꯝꯅꯁꯨ
মীয়াম্না	ꯃꯤꯌꯥꯝꯅꯥ
মীয়াম্বু	ꯃꯤꯌꯥꯝꯕꯨ
মীয়াৎ	ꯃꯤꯌꯥꯠ
মীৱা	ꯃꯤꯋꯥ
মুইভা	ꯃꯨꯏꯚꯥ
মুক	ꯃꯨꯛ
মুকেশ	ꯃꯨꯀꯦꯁ
মুক্নবগী	ꯃꯨꯛꯅꯕꯒꯤ
মুক্নবা	ꯃꯨꯛꯅꯕꯥ
মুক্নরিবা	ꯃꯨꯛꯅꯔꯤꯕꯥ
মুখর্জি	ꯃꯨꯈꯔꯖꯤ
মুখর্জিগী	ꯃꯨꯈꯔꯖꯤꯒꯤ
মুগা	ꯃꯨꯒꯥ
মুজাফর	ꯃꯨꯖꯥꯐꯔ
মুজাহিদিনগী	ꯃꯨꯖꯥꯍꯤꯗꯤꯅꯒꯤ
মুজিবুর	ꯃꯨꯖꯤꯕꯨꯔ
মুণি	ꯃꯨꯅꯤ
মুতুম	ꯃꯨꯇꯨꯝ
মুত্থৎখিনবা	ꯃꯨꯠꯊꯠꯈꯤꯅꯕꯥ
মুত্থৎখিবা	ꯃꯨꯠꯊꯠꯈꯤꯕꯥ
মুত্থৎনবা	ꯃꯨꯠꯊꯠꯅꯕꯥ
মুত্থৎপদা	ꯃꯨꯠꯊꯠꯄꯗꯥ
মুত্থৎপা	ꯃꯨꯠꯊꯠꯄꯥ
মুত্থৎসি	ꯃꯨꯠꯊꯠꯁꯤ
মুথৎনবা	ꯃꯨꯊꯠꯅꯕꯥ
মুনবা	ꯃꯨꯟꯕꯥ
মুন্দুনা	ꯃꯨꯟꯗꯨꯅꯥ
মুন্নবগী	ꯃꯨꯟꯅꯕꯒꯤ
মুন্নবা	ꯃꯨꯟꯅꯕꯥ
মুন্না	ꯃꯨꯟꯅꯥ
মুবা	ꯃꯨꯕꯥ
মুবারক	ꯃꯨꯕꯥꯔꯛ
মুভমেন্ট	ꯃꯨꯚꯃꯦꯟꯠ
মুম্বাই	ꯃꯨꯝꯕꯥꯏ
মুম্বাইগী	ꯃꯨꯝꯕꯥꯏꯒꯤ
মুম্বাইদা	ꯃꯨꯝꯕꯥꯏꯗꯥ
মুরালিধরন	ꯃꯨꯔꯥꯂꯤꯙꯔꯟ
মুরালিধরনগী	ꯃꯨꯔꯥꯂꯤꯙꯔꯟꯒꯤ
মুরালিধরননা	ꯃꯨꯔꯥꯂꯤꯙꯔꯟꯅꯥ
মুরুম	ꯃꯨꯔꯨꯃ
মুসলমান	ꯃꯨꯁꯜꯃꯥꯟ
মুসলিম	ꯃꯨꯁꯂꯤꯝ
মুসলিমশিংগী	ꯃꯨꯁꯂꯤꯝꯁꯤꯡꯒꯤ
মুসলিমশিংনা	ꯃꯨꯁꯂꯤꯝꯁꯤꯡꯅꯥ
মুস্লিম	ꯃꯨꯁꯂꯤꯝ
মুস্লিমশিংগী	ꯃꯨꯁꯂꯤꯝꯁꯤꯡꯒꯤ
মুৎখি	ꯃꯨꯠꯈꯤ
মুৎখ্রবা	ꯃꯨꯠꯈ꯭ꯔꯕꯥ
মুৎনাইদ্রবা	ꯃꯨꯠꯅꯥꯏꯗ꯭ꯔꯕꯥ
মূন	ꯃꯨꯅ
মে	ꯃꯦ
মেক	ꯃꯦꯛ
মেকর	ꯃꯦꯀꯔ
মেকানিকেল	ꯃꯦꯀꯥꯅꯤꯀꯦꯜ
মেকানিজম	ꯃꯦꯀꯥꯅꯤꯖꯝ
মেক্কর	ꯃꯦꯛꯀꯔ
মেক্স	ꯃꯦꯀ꯭ꯁ
মেক্সিমম	ꯃꯦꯛꯁꯤꯃꯝ
মেগজিনগা	ꯃꯦꯒꯖꯤꯟꯒꯥ
মেগা	ꯃꯦꯒꯥ
মেগী	ꯃꯦꯒꯤ
মেঘচন্দ্র	ꯃꯦꯘꯆꯟꯗ꯭ꯔ
মেঘচন্দ্রনা	ꯃꯦꯘꯆꯟꯗ꯭ꯔꯅꯥ
মেঘালায়া	ꯃꯦꯘꯥꯂꯥꯌꯥ
মেঘালায়াগী	ꯃꯦꯘꯥꯂꯥꯌꯥꯒꯤ
মেঘালয়	ꯃꯦꯘꯥꯂꯌ
মেঘালয়গী	ꯃꯦꯘꯥꯂꯌꯒꯤ
মেঘালয়দা	ꯃꯦꯘꯥꯂꯌꯗꯥ
মেঘালয়া	ꯃꯦꯘꯥꯂꯌꯥ
মেঘালয়াদা	ꯃꯦꯘꯥꯂꯌꯥꯗꯥ
মেছিন	ꯃꯦꯁꯤꯟ
মেছিনরিশিংগী	ꯃꯦꯁꯤꯟꯔꯤꯁꯤꯡꯒꯤ
মেছিন্নরি	ꯃꯦꯁꯤꯟꯅꯔꯤ
মেজর	ꯃꯦꯖꯔ
মেজরশিং	ꯃꯦꯖꯔꯁꯤꯡ
মেজিষ্ট্রেটনা	ꯃꯦꯖꯤꯁꯇ꯭ꯔꯦꯠꯅꯥ
মেট	ꯃꯦꯠ
মেটচ	ꯃꯦꯠꯆ
মেটচকী	ꯃꯦꯠꯆꯀꯤ
মেটচতা	ꯃꯦꯠꯆꯇꯥ
মেটচনা	ꯃꯦꯠꯆꯅꯥ
মেটচশিং	ꯃꯦꯠꯆꯁꯤꯡ
মেটরিয়েলশিং	ꯃꯦꯇꯔꯤꯌꯦꯜꯁꯤꯡ
মেটশিং	ꯃꯦꯠꯁꯤꯡ
মেদল	ꯃꯦꯗꯜ
মেদা	ꯃꯦꯗꯥ
মেদিক	ꯃꯦꯗꯤꯛ
মেদিকেল	ꯃꯦꯗꯤꯀꯦꯜ
মেদিসিন	ꯃꯦꯗꯤꯁꯤꯟ
মেদিসিনগা	ꯃꯦꯗꯤꯁꯤꯟꯒꯥ
মেদিসিনগী	ꯃꯦꯗꯤꯁꯤꯟꯒꯤ
মেদিসিনদা	ꯃꯦꯗꯤꯁꯤꯟꯗꯥ
মেদিয়না	ꯃꯦꯗꯤꯌꯅꯥ
মেদিয়ম	ꯃꯦꯗꯤꯌꯝ
মেদিয়া	ꯃꯦꯗꯤꯌꯥ
মেদিয়াগী	ꯃꯦꯗꯤꯌꯥꯒꯤ
মেদিয়াদা	ꯃꯦꯗꯤꯌꯥꯗꯥ
মেদিয়ানা	ꯃꯦꯗꯤꯌꯥꯅꯥ
মেদিয়াবু	ꯃꯦꯗꯤꯌꯥꯕꯨ
মেন	ꯃꯦꯟ
মেনখৎতুনা	ꯃꯦꯟꯈꯠꯇꯨꯅꯥ
মেনখৎনবা	ꯃꯦꯟꯈꯠꯅꯕꯥ
মেনখৎপা	ꯃꯦꯟꯈꯠꯄꯥ
মেনপৱার	ꯃꯦꯟꯄꯋꯥꯔ
মেনপৱারগী	ꯃꯦꯟꯄꯋꯥꯔꯒꯤ
মেনশিনবা	ꯃꯦꯟꯁꯤꯟꯕꯥ
মেনশিন্ননবা	ꯃꯦꯟꯁꯤꯟꯅꯅꯕꯥ
মেনশিন্নবা	ꯃꯦꯟꯁꯤꯟꯅꯕꯥ
মেনু	ꯃꯦꯅꯨ
মেনেজমেন্ট	ꯃꯦꯅꯦꯖꯃꯦꯟꯠ
মেনেজমেন্টকী	ꯃꯦꯅꯦꯖꯃꯦꯟꯠꯀꯤ
মেনেজমেন্টতা	ꯃꯦꯅꯦꯖꯃꯦꯟꯠꯇꯥ
মেনেজমেন্টনা	ꯃꯦꯅꯦꯖꯃꯦꯟꯠꯅꯥ
মেনেজর	ꯃꯦꯅꯦꯖꯔ
মেনেজরনা	ꯃꯦꯅꯦꯖꯔꯅꯥ
মেনেজিং	ꯃꯦꯅꯦꯖꯤꯡ
মেন্টিনেন্স	ꯃꯦꯟꯇꯤꯅꯦꯟꯁ
মেন্টেল	ꯃꯦꯟꯇꯦꯜ
মেন্স	ꯃꯦꯟꯁ
মেপ	ꯃꯦꯞ
মেপতা	ꯃꯦꯞꯇꯥ
মেমচা	ꯃꯦꯝꯆꯥ
মেমচাগী	ꯃꯦꯝꯆꯥꯒꯤ
মেমচানা	ꯃꯦꯝꯆꯥꯅꯥ
মেম্বর	ꯃꯦꯝꯕꯔ
মেম্বরনি	ꯃꯦꯝꯕꯔꯅꯤ
মেম্বরশিং	ꯃꯦꯝꯕꯔꯁꯤꯡ
মেম্বরশিংগা	ꯃꯦꯝꯕꯔꯁꯤꯡꯒꯥ
মেম্বরশিংগী	ꯃꯦꯝꯕꯔꯁꯤꯡꯒꯤ
মেম্বরশিংদগী	ꯃꯦꯝꯕꯔꯁꯤꯡꯗꯒꯤ
মেম্বরশিংদা	ꯃꯦꯝꯕꯔꯁꯤꯡꯗꯥ
মেম্বরশিংনা	ꯃꯦꯝꯕꯔꯁꯤꯡꯅꯥ
মেম্বরশিংবু	ꯃꯦꯝꯕꯔꯁꯤꯡꯕꯨ
মেম্বরশিংসু	ꯃꯦꯝꯕꯔꯁꯤꯡꯁꯨ
মেম্বরসিপ	ꯃꯦꯝꯕꯔꯁꯤꯞ
মেম্বরসু	ꯃꯦꯝꯕꯔꯁꯨ
মেম্মা	ꯃꯦꯝꯃꯥ
মেরা	ꯃꯦꯔꯥ
মেরাগী	ꯃꯦꯔꯥꯒꯤ
মেরি	ꯃꯦꯔꯤ
মেরিট	ꯃꯦꯔꯤꯇꯠ
মেরিটাইম	ꯃꯦꯔꯤꯇꯥꯏꯝ
মেল	ꯃꯦꯜ
মেলদা	ꯃꯦꯜꯗꯥ
মেলা	ꯃꯦꯂꯥ
মেলাদা	ꯃꯦꯂꯥꯗꯥ
মেলাশিং	ꯃꯦꯂꯥꯁꯤꯡ
মেলাশিংদা	ꯃꯦꯂꯥꯁꯤꯡꯗꯥ
মেলাসু	ꯃꯦꯂꯥꯁꯨ
মেসেজ	ꯃꯦꯁꯦꯖ
মেয়র	ꯃꯦꯌꯔ
মৈ	ꯃꯩ
মৈকাপ্পী	ꯃꯩꯀꯥꯞꯄꯤ
মৈখু	ꯃꯩꯈꯨ
মৈগী	ꯃꯩꯒꯤ
মৈঙাল	ꯃꯩꯉꯥꯂ
মৈঙালনা	ꯃꯩꯉꯥꯜꯅꯥ
মৈচাক	ꯃꯩꯆꯥꯛ
মৈচাক্না	ꯃꯩꯆꯥꯛꯅꯥ
মৈতাল	ꯃꯩꯇꯥꯂ
মৈতৈ	ꯃꯩꯇꯩ
মৈতৈনা	ꯃꯩꯇꯩꯅꯥ
মৈতৈবু	ꯃꯩꯇꯩꯕꯨ
মৈতৈশিংনা	ꯃꯩꯇꯩꯁꯤꯡꯅꯥ
মৈদা	ꯃꯩꯗꯥ
মৈদানদা	ꯃꯩꯗꯥꯟꯗꯥ
মৈদিংঙু	ꯃꯩꯗꯤꯡꯉꯨ
মৈনম	ꯃꯩꯅꯝ
মৈনা	ꯃꯩꯅꯥ
মৈফু	ꯃꯩꯐꯨ
মৈরা	ꯃꯩꯔꯥ
মৈরানি	ꯃꯩꯔꯥꯅꯤ
মৈরী	ꯃꯩꯔꯤ
মৈশা	ꯃꯩꯁꯥ
মৈস্নাম	ꯃꯩꯁꯅꯥꯝ
ম্না	ꯃꯅꯥ
ম্যুজিক	ꯃꯌ꯭ꯨꯖꯤꯀ
ম্যুনিসিপাল	ꯃꯌ꯭ꯨꯅꯤꯁꯤꯄꯥꯂ
ময়া	ꯃꯌꯥ
ময়াং	ꯃꯌꯥꯡ
ময়াংলম্বম	ꯃꯌꯥꯡꯂꯝꯕꯝ
ময়াংলম্বমনা	ꯃꯌꯥꯡꯂꯝꯕꯝꯅꯥ
ময়াই	ꯃꯌꯥꯏ
ময়াইদা	ꯃꯌꯥꯏꯗꯥ
ময়াগী	ꯃꯌꯥꯒꯤ
ময়াঙ	ꯃꯌꯥꯉ
ময়াদগী	ꯃꯌꯥꯗꯒꯤ
ময়াদা	ꯃꯌꯥꯗꯥ
ময়াম	ꯃꯌꯥꯝ
ময়ামগী	ꯃꯌꯥꯝꯒꯤ
ময়ামদা	ꯃꯌꯥꯝꯗꯥ
ময়ামনা	ꯃꯌꯥꯝꯅꯥ
ময়ামসু	ꯃꯌꯥꯝꯁꯨ
ময়াম্না	ꯃꯌꯥꯝꯅꯥ
ময়াম্বগী	ꯃꯌꯥꯝꯕꯒꯤ
ময়াম্বনা	ꯃꯌꯥꯝꯕꯅꯥ
ময়াম্বা	ꯃꯌꯥꯝꯕꯥ
ময়াম্বুং	ꯃꯌꯥꯝꯕꯨꯡ
ময়ায়	ꯃꯌꯥꯌ
ময়ি	ꯃꯌꯤ
ময়ুম	ꯃꯌꯨꯝ
ময়ুমদগী	ꯃꯌꯨꯝꯗꯒꯤ
ময়ুমদা	ꯃꯌꯨꯝꯗꯥ
ময়ূম	ꯃꯌꯨꯃ
ময়েং	ꯃꯌꯦꯡ
ময়েক	ꯃꯌꯦꯛ
ময়েকপু	ꯃꯌꯦꯛꯄꯨ
ময়েক্কী	ꯃꯌꯦꯛꯀꯤ
ময়েক্না	ꯃꯌꯦꯛꯅꯥ
মৱা	ꯃꯋꯥ
যিশুনা	ꯖꯤꯁꯨꯅꯥ
যুগ	ꯖꯨꯒ
যুব	ꯖꯨꯕ
যুবরাজ	ꯖꯨꯕꯔꯥꯖ
যুবা	ꯖꯨꯕꯥ
র	ꯔ
রং	ꯔꯪ
রক	ꯔꯛ
রচনা	ꯔꯆꯅꯥ
রজিব	ꯔꯖꯤꯕ
রঞ্জন	ꯔꯟꯖꯟ
রঞ্জনগী	ꯔꯟꯖꯟꯒꯤ
রঞ্জননা	ꯔꯟꯖꯟꯅꯥ
রঞ্জনা	ꯔꯟꯖꯅꯥ
রঞ্জিৎ	ꯔꯟꯖꯤꯠ
রঞ্জিৎকুমার	ꯔꯟꯖꯤꯠꯀꯨꯃꯥꯔ
রঞ্জিৎনা	ꯔꯟꯖꯤꯠꯅꯥ
রতন	ꯔꯇꯟ
রতনকুমার	ꯔꯇꯟꯀꯨꯃꯥꯔ
রত্না	ꯔꯠꯅꯥ
রথ	ꯔꯊ
রদা	ꯔꯗꯥ
রন	ꯔꯟ
রনা	ꯔꯅꯥ
রন্দিপ	ꯔꯟꯗꯤꯞ
রবর	ꯔꯕꯔ
রবি	ꯔꯕꯤ
রবিকুমার	ꯔꯕꯤꯀꯨꯃꯥꯔ
রবিনা	ꯔꯕꯤꯅꯥ
রবিন্দ্র	ꯔꯕꯤꯟꯗ꯭ꯔ
রবিবু	ꯔꯕꯤꯕꯨ
রমানন্দা	ꯔꯃꯥꯅꯟꯗꯥ
রসিয়া	ꯔꯁꯤꯌꯥ
রসিয়ানা	ꯔꯁꯤꯌꯥꯅꯥ
রহমনগী	ꯔꯍꯝꯅꯒꯤ
রহমননা	ꯔꯍꯝꯅꯅꯥ
রা	ꯔꯥ
রাং	ꯔꯥꯡ
রাই	ꯔꯥꯏ
রাইওট	ꯔꯥꯏꯑꯣꯠ
রাইজিং	ꯔꯥꯏꯖꯤꯡ
রাইট	ꯔꯥꯏꯇ
রাইটর	ꯔꯥꯏꯇꯔ
রাইটরস	ꯔꯥꯏꯇꯔꯁ
রাইটস	ꯔꯥꯏꯠꯁ
রাইটসকী	ꯔꯥꯏꯠꯁꯀꯤ
রাইটসনা	ꯔꯥꯏꯠꯁꯅꯥ
রাইত	ꯔꯥꯏꯠ
রাইদর	ꯔꯥꯏꯗꯔ
রাইদিং	ꯔꯥꯏꯗꯤꯡ
রাইফল	ꯔꯥꯏꯐꯜ
রাইফলমেন	ꯔꯥꯏꯐꯜꯃꯦꯟ
রাইফলস	ꯔꯥꯏꯐꯜꯁ
রাইফলসকী	ꯔꯥꯏꯐꯜꯁꯀꯤ
রাইফলসনা	ꯔꯥꯏꯐꯜꯁꯅꯥ
রাও	ꯔꯥꯑꯣ
রাওনা	ꯔꯥꯑꯣꯅꯥ
রাগ	ꯔꯥꯒ
রাজ	ꯔꯥꯖ
রাজকী	ꯔꯥꯖꯀꯤ
রাজকুমার	ꯔꯥꯖꯀꯨꯃꯥꯔ
রাজকুমারি	ꯔꯥꯖꯀꯨꯃꯥꯔꯤ
রাজগী	ꯔꯥꯖꯒꯤ
রাজনিতি	ꯔꯥꯖꯅꯤꯇꯤ
রাজনিতিগী	ꯔꯥꯖꯅꯤꯇꯤꯒꯤ
রাজনিতিদা	ꯔꯥꯖꯅꯤꯇꯤꯗꯥ
রাজনীতি	ꯔꯥꯖꯅꯤꯇꯤ
রাজনীতিগী	ꯔꯥꯖꯅꯤꯇꯤꯒꯤ
রাজনীতিদা	ꯔꯥꯖꯅꯤꯇꯤꯗꯥ
রাজপক্সানা	ꯔꯥꯖꯄꯛꯁꯥꯅꯥ
রাজপুত	ꯔꯥꯖꯄꯨꯠ
রাজভবনগী	ꯔꯥꯖꯚꯕꯟꯒꯤ
রাজস্থান	ꯔꯥꯖꯁꯊꯥꯟ
রাজস্থানগী	ꯔꯥꯖꯁꯊꯥꯟꯒꯤ
রাজস্থানদা	ꯔꯥꯖꯁꯊꯥꯟꯗꯥ
রাজা	ꯔꯥꯖꯥ
রাজিন্দর	ꯔꯥꯖꯤꯟꯗꯔ
রাজিব	ꯔꯥꯖꯤꯕ
রাজু	ꯔꯥꯖꯨ
রাজুনা	ꯔꯥꯖꯨꯅꯥ
রাজেন	ꯔꯥꯖꯦꯟ
রাজেনদা	ꯔꯥꯖꯦꯟꯗꯥ
রাজেননা	ꯔꯥꯖꯦꯟꯅꯥ
রাজেন্দ্র	ꯔꯥꯖꯦꯟꯗ꯭ꯔ
রাজেশ	ꯔꯥꯖꯦꯁ
রাজেস	ꯔꯥꯖꯦꯁ
রাজেসকুমার	ꯔꯥꯖꯦꯁꯀꯨꯃꯥꯔ
রাজেসনা	ꯔꯥꯖꯦꯁꯅꯥ
রাঞ্চি	ꯔꯥꯟꯆꯤ
রাঞ্চিদা	ꯔꯥꯟꯆꯤꯗꯥ
রাণি	ꯔꯥꯅꯤ
রাধা	ꯔꯥꯙꯥ
রাধে	ꯔꯥꯙꯦ
রানা	ꯔꯥꯅꯥ
রানি	ꯔꯥꯅꯤ
রাম	ꯔꯥꯝ
রামকৃষ্ণ	ꯔꯥꯃꯛꯔꯁꯅ
রামগী	ꯔꯥꯝꯒꯤ
রামেশ	ꯔꯥꯃꯦꯁ
রামেশচন্দ্র	ꯔꯥꯃꯦꯁꯆꯟꯗ꯭ꯔ
রামেশ্বর	ꯔꯥꯃꯦꯁ꯭ꯋꯔ
রামেশ্বরনা	ꯔꯥꯃꯦꯁ꯭ꯋꯔꯅꯥ
রামেশ্বরবু	ꯔꯥꯃꯦꯁ꯭ꯋꯔꯕꯨ
রাশি	ꯔꯥꯁꯤ
রাষ্ট্রপতি	ꯔꯥꯁꯇ꯭ꯔꯄꯇꯤ
রাষ্ট্রিয়া	ꯔꯥꯁꯇ꯭ꯔꯤꯌꯥ
রাস	ꯔꯥꯁ
রাসমনি	ꯔꯥꯁꯝꯅꯤ
রাসু	ꯔꯥꯁꯨ
রাহুল	ꯔꯥꯍꯨꯜ
রাৱটনা	ꯔꯥꯋꯠꯅꯥ
রি	ꯔꯤ
রিএক্সন	ꯔꯤꯑꯦꯛꯁꯟ
রিও	ꯔꯤꯑꯣ
রিওদা	ꯔꯤꯑꯣꯗꯥ
রিওনা	ꯔꯤꯑꯣꯅꯥ
রিকগনাইজ	ꯔꯤꯀꯒꯅꯥꯏꯖ
রিকমেন্দ	ꯔꯤꯀꯃꯦꯟꯗ
রিকমেন্দেসন	ꯔꯤꯀꯃꯦꯟꯗꯦꯁꯟ
রিকমেন্দেসনশিং	ꯔꯤꯀꯃꯦꯟꯗꯦꯁꯟꯁꯤꯡ
রিক্স	ꯔꯤꯀ꯭ꯁ
রিগুলর	ꯔꯤꯒꯨꯂꯔ
রিগুলার	ꯔꯤꯒꯨꯂꯥꯔ
রিগুলেসন	ꯔꯤꯒꯨꯂꯦꯁꯟ
রিগুলেসন্স	ꯔꯤꯒꯨꯂꯦꯁꯟꯁ
রিচার্চ	ꯔꯤꯆꯥꯔꯆ
রিছার্স	ꯔꯤꯁꯥꯔꯁ
রিছার্সকী	ꯔꯤꯁꯥꯔꯁꯀꯤ
রিজন	ꯔꯤꯖꯟ
রিজনগী	ꯔꯤꯖꯟꯒꯤ
রিজনদা	ꯔꯤꯖꯟꯗꯥ
রিজনেল	ꯔꯤꯖꯅꯦꯜ
রিজল্ট	ꯔꯤꯖꯜꯠ
রিজাইন	ꯔꯤꯖꯥꯏꯟ
রিজার্ব	ꯔꯤꯖꯥꯔ꯭ꯕ
রিজার্বনি	ꯔꯤꯖꯥꯔ꯭ꯕꯅꯤ
রিজার্বশিং	ꯔꯤꯖꯥꯔ꯭ꯕꯁꯤꯡ
রিজার্ভ	ꯔꯤꯖꯥꯔ꯭ꯚ
রিজার্ভেসন	ꯔꯤꯖꯥꯔꯚꯦꯁꯟ
রিজিজু	ꯔꯤꯖꯤꯖꯨ
রিজিজুনা	ꯔꯤꯖꯤꯖꯨꯅꯥ
রিটর্নিং	ꯔꯤꯇꯔꯅꯤꯡ
রিটেল	ꯔꯤꯇꯦꯜ
রিটয়ার্দ	ꯔꯤꯇ꯭ꯌꯥꯔꯗ
রিতন	ꯔꯤꯇꯟ
রিতু	ꯔꯤꯇꯨ
রিদিং	ꯔꯤꯗꯤꯡ
রিদ্রেসেল	ꯔꯤꯗꯔꯦꯁꯦꯜ
রিপব্লিক	ꯔꯤꯄꯕꯂꯤꯀ
রিপিল	ꯔꯤꯄꯤꯜ
রিপিলিং	ꯔꯤꯄꯤꯂꯤꯡ
রিপ্রজেন্টেটিব	ꯔꯤꯄꯔ꯭ꯖꯦꯟꯇꯦꯇꯤꯕ
রিফর	ꯔꯤꯐꯔ
রিফরেন্স	ꯔꯤꯐꯔꯦꯟꯁ
রিফরেল	ꯔꯤꯐꯔꯦꯜ
রিফাইন	ꯔꯤꯐꯥꯏꯟ
রিফ্যুজি	ꯔꯤꯐꯖꯨꯖꯤ
রিফ্যুজিশিং	ꯔꯤꯐꯖꯨꯖꯤꯁꯤꯡ
রিবা	ꯔꯤꯕꯥ
রিভর	ꯔꯤꯚꯔ
রিভাইস	ꯔꯤꯚꯥꯏꯁ
রিভিয়ু	ꯔꯤꯚꯤꯌꯨ
রিমস	ꯔꯤꯃꯁ
রিমসকী	ꯔꯤꯃꯁꯀꯤ
রিমসগী	ꯔꯤꯃꯁꯒꯤ
রিমসতগী	ꯔꯤꯃꯁꯠꯒꯤ
রিমসতা	ꯔꯤꯃꯁꯇꯥ
রিমসপু	ꯔꯤꯃꯁꯄꯨ
রিমান্দ	ꯔꯤꯃꯥꯟꯗ
রিলিজ	ꯔꯤꯂꯤꯖ
রিলিফ	ꯔꯤꯂꯤꯐ
রিলেসন	ꯔꯤꯂꯦꯁꯟ
রিলেসন্সকী	ꯔꯤꯂꯦꯁꯟꯁꯀꯤ
রিহারসেল	ꯔꯤꯍꯥꯔꯁꯦꯜ
রিহেবিলিটেসন	ꯔꯤꯍꯦꯕꯤꯂꯤꯇꯦꯁꯟ
রিয়াং	ꯔꯤꯌꯥꯡ
রিয়েক্সন	ꯔꯤꯌꯦꯛꯁꯟ
রিয়েল	ꯔꯤꯌꯦꯜ
রিয়েলাইজেসন	ꯔꯤꯌꯦꯂꯥꯏꯖꯦꯁꯟ
রুট	ꯔꯨꯇ
রুটিন	ꯔꯨꯇꯤꯟ
রুতিন	ꯔꯨꯇꯤꯟ
রুপ	ꯔꯨꯄ
রুপমহল	ꯔꯨꯄꯝꯍꯜ
রুবেন	ꯔꯨꯕ⁰ꯟ
রুম	ꯔꯨꯃ
রুমগী	ꯔꯨꯃꯒꯤ
রুমদা	ꯔꯨꯃꯗꯥ
রুমশিং	ꯔꯨꯃꯁꯤꯡ
রুমাল	ꯔꯨꯃꯥꯜ
রুরেল	ꯔꯨꯔꯦꯜ
রুল	ꯔꯨꯂ
রুলগী	ꯔꯨꯂꯒꯤ
রুলশিং	ꯔꯨꯂꯁꯤꯡ
রুলস	ꯔꯨꯂꯁ
রে	ꯔꯦ
রেংপাং	ꯔꯦꯡꯄꯥꯡ
রেইদ	ꯔꯦꯏꯗ
রেকেট	ꯔꯦꯀꯦꯇ
রেগুলর	ꯔꯦꯒꯨꯂꯔ
রেগুলেট	ꯔꯦꯒꯨꯂꯦꯇ
রেগুলেসন	ꯔꯦꯒꯨꯂꯦꯁꯟ
রেঙ্ক	ꯔꯦꯡꯀ
রেঙ্কিং	ꯔꯦꯡꯀꯤꯡ
রেঙ্কিংদা	ꯔꯦꯡꯀꯤꯡꯗꯥ
রেজিষ্টর	ꯔꯦꯖꯤꯁꯇ꯭ꯔ
রেজিষ্টার	ꯔꯦꯖꯤꯁꯇ꯭ꯥꯔ
রেজিষ্ট্রেসন	ꯔꯦꯖꯤꯁꯇ꯭ꯔꯦꯁꯟ
রেঞ্জ	ꯔꯦꯟꯖ
রেঞ্জতা	ꯔꯦꯟꯖꯇꯥ
রেট	ꯔꯦꯇ
রেড	ꯔꯦꯗ
রেডিও	ꯔꯦꯗꯤꯑꯣ
রেদ	ꯔꯦꯗ
রেদি	ꯔꯦꯗꯤ
রেদিও	ꯔꯦꯗꯤꯑꯣ
রেদিওগী	ꯔꯦꯗꯤꯑꯣꯒꯤ
রেদ্দি	ꯔꯦꯗꯗꯤ
রেদ্দিনা	ꯔꯦꯗꯗꯤꯅꯥ
রেন	ꯔꯦꯅ
রেপ	ꯔꯦꯄ
রেপিদ	ꯔꯦꯄꯤꯗ
রেভিন্যু	ꯔꯦꯚꯤꯅꯨꯖ
রেভিন্যুদা	ꯔꯦꯚꯤꯅꯨꯖꯗꯥ
রেমদেসিবির	ꯔꯦꯝꯗꯦꯁꯤꯕꯤꯔ
রেল	ꯔꯦꯜ
রেলগী	ꯔꯦꯂꯒꯤ
রেলদা	ꯔꯦꯂꯗꯥ
রেল্লি	ꯔꯦꯜꯂꯤ
রেল্লিদা	ꯔꯦꯜꯂꯤꯗꯥ
রেলৱে	ꯔꯦꯂꯋꯦ
রেলৱেগী	ꯔꯦꯜꯋꯦꯒꯤ
রেলৱেজ	ꯔꯦꯜꯋꯦꯖ
রেলৱেজগী	ꯔꯦꯜꯋꯦꯖꯒꯤ
রেলৱেজতা	ꯔꯦꯜꯋꯦꯖꯇꯥ
রেলৱেনা	ꯔꯦꯡꯋꯦꯅꯥ
রেষ্টলিং	ꯔꯦꯁꯇ꯭ꯂꯤꯡ
রেষ্টলিংদা	ꯔꯦꯁꯇ꯭ꯂꯤꯡꯗꯥ
রেষ্টুরেন্ট	ꯔꯦꯁꯇꯨꯔꯦꯟꯇ
রেষ্ট্রিক্সন	ꯔꯦꯁꯇ꯭ꯔꯤꯛꯁꯟ
রেস	ꯔꯦꯁ
রেসন	ꯔꯦꯁꯟ
রেসিদেন্ট	ꯔꯦꯁꯤꯗꯦꯟꯇ
রেসিদেন্স	ꯔꯦꯁꯤꯗꯦꯟꯁ
রেসিদেন্সতা	ꯔꯦꯁꯤꯗꯦꯟꯁꯇꯥ
রেসিদেন্সিয়েল	ꯔꯦꯁꯤꯗꯦꯟꯁꯤꯌꯦꯜ
রেস্পিরেটরি	ꯔꯦꯁꯄꯤꯔꯦꯇꯔꯤ
লং	ꯂꯪ
লংগা	ꯂꯪꯒꯥ
লংজিন	ꯂꯪꯖꯤꯅ
লংথবাল	ꯂꯪꯊꯕꯥꯜ
লংথবালনা	ꯂꯪꯊꯕꯥꯜꯅꯥ
লংদুনা	ꯂꯪꯗꯨꯅꯥ
লংনা	ꯂꯪꯅꯥ
লংবদা	ꯂꯪꯕꯗꯥ
লংমাই	ꯂꯪꯃꯥꯏ
লংলবা	ꯂꯪꯂꯕꯥ
লংলা	ꯂꯪꯂꯥ
লইনা	ꯂꯏꯅꯥ
লক	ꯂꯛ
লকি	ꯂꯀꯤ
লক্নখি	ꯂꯛꯅꯈꯤ
লক্লিবা	ꯂꯛꯂꯤꯕꯥ
লক্লে	ꯂꯛꯂꯦ
লক্ষ্মী	ꯂꯛꯁꯃꯤ
লদাখ	ꯂꯗꯥꯈ
লদাখকী	ꯂꯗꯥꯈꯀꯤ
লদাখতা	ꯂꯗꯥꯈꯇꯥ
লদু	ꯂꯗꯨ
লন	ꯂꯟ
লননি	ꯂꯟꯅꯤ
লনাই	ꯂꯅꯥꯏ
লন্দন	ꯂꯟꯗꯟ
লন্দনগী	ꯂꯟꯗꯟꯒꯤ
লন্দনদগী	ꯂꯟꯗꯟꯗꯒꯤ
লন্দনদা	ꯂꯟꯗꯟꯗꯥ
লন্নাই	ꯂꯟꯅꯥꯏ
লন্নাইগী	ꯂꯟꯅꯥꯏꯒꯤ
লফু	ꯂꯐꯨ
লব	ꯂꯕ
লভ	ꯂꯚ
লম	ꯂꯝ
লমকাং	ꯂꯝꯀꯥꯡ
লমকাদা	ꯂꯝꯀꯥꯗꯥ
লমখাই	ꯂꯝꯈꯥꯏ
লমগা	ꯂꯝꯒꯥ
লমগী	ꯂꯝꯒꯤ
লমচৎ	ꯂꯝꯆꯠ
লমজাও	ꯂꯝꯖꯥꯎ
লমজিং	ꯂꯝꯖꯤꯡ
লমজিংনবা	ꯂꯝꯖꯤꯡꯅꯕꯥ
লমজিংবা	ꯂꯝꯖꯤꯡꯕꯥ
লমজেল	ꯂꯝꯖꯦꯜ
লমজেলদা	ꯂꯝꯖꯦꯜꯗꯥ
লমতাক	ꯂꯝꯇꯥꯛ
লমথাখিবা	ꯂꯝꯊꯥꯈꯤꯕꯥ
লমথাখ্রে	ꯂꯝꯊꯥꯈꯔꯦ
লমথাবগী	ꯂꯝꯊꯥꯕꯒꯤ
লমদগী	ꯂꯝꯗꯒꯤ
লমদদি	ꯂꯝꯗꯗꯤ
লমদম	ꯂꯝꯗꯝ
লমদমগী	ꯂꯝꯗꯝꯒꯤ
লমদমদগী	ꯂꯝꯗꯝꯗꯒꯤ
লমদমদা	ꯂꯝꯗꯝꯗꯥ
লমদমনি	ꯂꯝꯗꯝꯅꯤ
লমদমবু	ꯂꯝꯗꯝꯕꯨ
লমদমশিংদা	ꯂꯝꯗꯝꯁꯤꯡꯗꯥ
লমদমসিগী	ꯂꯝꯗꯝꯁꯤꯒꯤ
লমদমসিদা	ꯂꯝꯗꯝꯁꯤꯗꯥ
লমদমসিবু	ꯂꯝꯗꯝꯁꯤꯕꯨ
লমদমা	ꯂꯝꯗꯃꯥ
লমদসু	ꯂꯝꯗꯁꯨ
লমদা	ꯂꯝꯗꯥ
লমদাই	ꯂꯝꯗꯥꯏ
লমদি	ꯂꯝꯗꯤ
লমদিং	ꯂꯝꯗꯤꯡ
লমদেং	ꯂꯝꯗꯦꯡ
লমন	ꯂꯝꯅ
লমনগী	ꯂꯝꯅꯒꯤ
লমনশিং	ꯂꯝꯅꯁꯤꯡ
লমনশিংদা	ꯂꯝꯅꯁꯤꯪꫪꯡꯗꯥ
লমনা	ꯂꯝꯅꯥ
লমফেল	ꯂꯝꯐꯦꯜ
লমবু	ꯂꯝꯕꯨ
লমলক্কী	ꯂꯝꯂꯛꯀꯤ
লমশাং	ꯂꯝꯁꯥꯡ
লমশিং	ꯂꯝꯁꯤꯡ
লমশিংগী	ꯂꯝꯁꯤꯡꯒꯤ
লমশিংদা	ꯂꯝꯁꯤꯡꯗꯥ
লমসিদা	ꯂꯝꯁꯤꯗꯥ
লমহাং	ꯂꯝꯍꯥꯪ
লমাবম	ꯂꯃꯥꯕꯝ
লম্পাক	ꯂꯝꯄꯥꯛ
লম্পাক্কী	ꯂꯝꯄꯥꯛꯀꯤ
লম্ফেল	ꯂꯝꯐꯦꯜ
লম্ফেলগী	ꯂꯝꯐꯦꯜꯒꯤ
লম্ফেলদা	ꯂꯝꯐꯦꯜꯗꯥ
লম্ফেলপাৎতা	ꯂꯝꯐꯦꯜꯄꯥꯠꯇꯥ
লম্বা	ꯂꯝꯕꯥ
লম্বী	ꯂꯝꯕꯤ
লম্বীগী	ꯂꯝꯕꯤꯒꯤ
লম্বীদগী	ꯂꯝꯕꯤꯗꯒꯤ
লম্বীদা	ꯂꯝꯕꯤꯗꯥ
লম্বীদি	ꯂꯝꯕꯤꯗꯤ
লম্বীদুদা	ꯂꯝꯕꯤꯗꯨꯗꯥ
লম্বীনা	ꯂꯝꯕꯤꯅꯥ
লম্বীনি	ꯂꯝꯕꯤꯅꯤ
লম্বীবু	ꯂꯝꯕꯤꯕꯨ
লম্বীশিং	ꯂꯝꯕꯤꯁꯤꯡ
লম্বীশিংগী	ꯂꯝꯕꯤꯁꯤꯡꯒꯤ
লম্বীশিংদা	ꯂꯝꯕꯤꯁꯤꯡꯗꯥ
লম্বীসু	ꯂꯝꯕꯤꯁꯨ
লম্বেল	ꯂꯝꯕꯦꯝ
লম্মন	ꯂꯝꯃꯟ
লম্মনশিং	ꯂꯝꯃꯟꯁꯤꯡ
লম্লক্কি	ꯂꯝꯂꯛꯀꯤ
লম্লক্কী	ꯂꯝꯂꯛꯀꯤ
লম্লাই	ꯂꯝꯂꯥꯏ
লম্লাইগী	ꯂꯝꯂꯥꯏꯒꯤ
লময়ানবা	ꯂꯝꯌꯥꯟꯕꯥ
লশিং	ꯂꯁꯤꯡ
লা	ꯂꯥ
লাং	ꯂꯥꯡ
লাংজিং	ꯂꯥꯡꯖꯤꯡ
লাংজিংগী	ꯂꯥꯪꯡꯡꯖꯤꯡꯒꯤ
লাংজিংদা	ꯂꯥꯡꯖꯤꯡꯗꯥ
লাংজিংনা	ꯂꯥꯜꯖꯤꯡꯅꯥ
লাংতক্নবা	ꯂꯥꯜꯇꯛꯅꯕꯥ
লাংথক	ꯂꯥꯜꯊꯛ
লাংথকশিং	ꯂꯥꯡꯊꯛꯁꯤꯡ
লাংথকশিংগী	ꯂꯥꯡꯊꯛꯁꯤꯜꯒꯤ
লাংদা	ꯂꯥꯜꯗꯥ
লাংদুনা	ꯂꯥꯪꯗꯨꯅꯥ
লাংবন	ꯂꯥꯡꯕꯟ
লাংবা	ꯂꯥꯡꯕꯥ
লাংলম্মী	ꯂꯥꯜꯂꯝꯃꯤ
লাংলিবশিংনা	ꯂꯥꯡꯂꯤꯕꯁꯤꯡꯅꯥ
লাংলিবা	ꯂꯥꯜꯂꯤꯕꯥ
লাংশিং	ꯂꯥꯡꯁꯤꯡ
লাই	ꯂꯥꯏ
লাইওং	ꯂꯥꯏꯑꯣꯡ
লাইওংশিং	ꯂꯥꯏꯑꯣꯡꯁꯤꯡ
লাইওইখ্রবা	ꯂꯥꯏꯑꯣꯏꯈꯔ꯭ꯕꯥ
লাইওন	ꯂꯥꯏꯑꯣꯅꯟ
লাইগী	ꯂꯥꯏꯒꯤ
লাইচৎ	ꯂꯥꯏꯆꯠ
লাইচৎকা	ꯂꯥꯏꯆꯠꯀꯥ
লাইচৎকী	ꯂꯥꯏꯆꯠꯀꯤ
লাইচৎতগী	ꯂꯥꯏꯆꯠꯇꯒꯤ
লাইচৎনা	ꯂꯥꯏꯆꯠꯅꯥ
লাইচৎপু	ꯂꯥꯏꯆꯠꯄꯨ
লাইট	ꯂꯥꯏꯇ
লাইটশিং	ꯂꯥꯏꯇꯁꯤꯡ
লাইটিং	ꯂꯥꯏꯇꯤꯡ
লাইদা	ꯂꯥꯏꯗꯥ
লাইন	ꯂꯥꯏꯅ
লাইনগী	ꯂꯥꯏꯅꯒꯤ
লাইনদা	ꯂꯥꯏꯅꯗꯥ
লাইনশিং	ꯂꯥꯏꯅꯁꯤꯡ
লাইনশিংগী	ꯂꯥꯏꯅꯁꯤꯡꯒꯤ
লাইনসু	ꯂꯥꯏꯅꯁꯨ
লাইনা	ꯂꯥꯏꯅꯥ
লাইনিং	ꯂꯥꯏꯅꯤꯡ
লাইনিংগী	ꯂꯥꯏꯅꯤꯡꯒꯤ
লাইনিংদা	ꯂꯥꯏꯅꯤꯡꯗꯥ
লাইনিংবা	ꯂꯥꯏꯅꯤꯡꯕꯥ
লাইনিংবু	ꯂꯥꯏꯅꯤꯡꯕꯨ
লাইনিংহল	ꯂꯥꯏꯅꯤꯡꯍꯜ
লাইনীং	ꯂꯥꯏꯅꯤꯪ
লাইনীংদা	ꯂꯥꯏꯅꯤꯪꯗꯥ
লাইন্স	ꯂꯥꯏꯟꯁ
লাইফ	ꯂꯥꯏꯐ
লাইফম	ꯂꯥꯏꯐꯝ
লাইফমদা	ꯂꯥꯏꯐꯝꯗꯥ
লাইফমলেন	ꯂꯥꯏꯐꯝꯂꯦꯟ
লাইফমলেনদা	ꯂꯥꯏꯐꯝꯂꯦꯟꯗꯥ
লাইফমলেনবু	ꯂꯥꯏꯐꯝꯂꯦꯟꯕꯨ
লাইফলাইন	ꯂꯥꯏꯐꯂꯥꯏꯟ
লাইব	ꯂꯥꯏꯕ
লাইবক	ꯂꯥꯏꯕꯛ
লাইবক্না	ꯂꯥꯏꯕꯛꯅꯥ
লাইবা	ꯂꯥꯏꯕꯥ
লাইবু	ꯂꯥꯏꯕꯨ
লাইবুং	ꯂꯥꯏꯕꯨꯪ
লাইব্রেরি	ꯂꯥꯏꯕꯔ⁰ꯔꯤ
লাইব্রেরী	ꯂꯥꯏꯕꯔ⁰ꯔꯤ
লাইভ	ꯂꯥꯏꯚ
লাইমন	ꯂꯥꯏꯝꯅ
লাইময়ুম	ꯂꯥꯏꯝꯌꯨꯝ
লাইর	ꯂꯥꯏꯔ
লাইরবগী	ꯂꯥꯏꯔꯕꯒꯤ
লাইরবনা	ꯂꯥꯏꯔꯕꯅꯥ
লাইরবশিং	ꯂꯥꯏꯔꯕꯁꯤꯡ
লাইরবশিংগী	ꯂꯥꯏꯔꯕꯁꯤꯡꯒꯤ
লাইরবশিংদা	ꯂꯥꯏꯔꯕꯁꯤꯡꯗꯥ
লাইরবশিংনা	ꯂꯥꯏꯔꯕꯁꯤꯡꯅꯥ
লাইরবা	ꯂꯥꯏꯔꯕꯥ
লাইরম্লেন্দা	ꯂꯥꯏꯔꯝꯂꯦꯟꯗꯥ
লাইরা	ꯂꯥꯏꯔꯥ
লাইরিক	ꯂꯥꯏꯔꯤꯛ
লাইরিকশিং	ꯂꯥꯏꯔꯤꯛꯁꯤꯡ
লাইরিকসু	ꯂꯥꯏꯔꯤꯛꯁꯨ
লাইরিক্কী	ꯂꯥꯏꯔꯤꯛꯀꯤ
লাইরিকয়েংবম	ꯂꯥꯏꯔꯤꯛꯌꯦꯡꯕꯝ
লাইরেন	ꯂꯥꯏꯔꯦꯅ
লাইরেম্বী	ꯂꯥꯏꯔꯦꯝꯕꯤ
লাইরেম্বীগী	ꯂꯥꯏꯔꯦꯝꯕꯤꯒꯤ
লাইরেম্বীদা	ꯂꯥꯏꯔꯦꯝꯕꯤꯗꯥ
লাইরেম্বীনা	ꯂꯥꯏꯔꯦꯝꯕꯤꯅꯥ
লাইরেল	ꯂꯥꯏꯔꯦꯜ
লাইরৈপাক	ꯂꯥꯏꯔꯩꯄꯥꯀ
লাইশঙ	ꯂꯥꯏꯁꯡ
লাইশঙদা	ꯂꯥꯏꯁꯡꯗꯥ
লাইশঙশিং	ꯂꯥꯏꯁꯡꯁꯤꯡ
লাইশু	ꯂꯥꯏꯁꯨ
লাইশুগী	ꯂꯥꯏꯁꯨꯒꯤ
লাইশুসু	ꯂꯥꯏꯁꯨꯁꯨ
লাইশ্রম	ꯂꯥꯏꯁꯔꯝ
লাইশ্রমনা	ꯂꯥꯏꯁꯔꯝꯅꯥ
লাইসেন্স	ꯂꯥꯏꯁꯦꯟꯁ
লাইয়াম্না	ꯂꯥꯏꯌꯥꯝꯅꯥ
লাইয়েকপা	ꯂꯥꯏꯌꯦꯛꯄꯥ
লাও	ꯂꯥꯑꯣ
লাওই	ꯂꯥꯑꯣꯏ
লাওনা	ꯂꯥꯑꯣꯅꯥ
লাক	ꯂꯥꯛ
লাকই	ꯂꯥꯛꯏ
লাকখি	ꯂꯥꯛꯈꯤ
লাকখিগনি	ꯂꯥꯛꯈꯤꯒꯅꯤ
লাকখিবগা	ꯂꯥꯛꯈꯤꯕꯒꯥ
লাকখিবগী	ꯂꯥꯛꯈꯤꯕꯒꯤ
লাকখিবদগী	ꯂꯥꯛꯈꯤꯕꯗꯒꯤ
লাকখিবনি	ꯂꯥꯛꯈꯤꯕꯅꯤ
লাকখিবা	ꯂꯥꯛꯈꯤꯕꯥ
লাকখ্রবসু	ꯂꯥꯛꯈꯔ꯭ꯕꯁꯨ
লাকখ্রবা	ꯂꯥꯛꯈꯔ꯭ꯕꯥ
লাকখ্রে	ꯂꯥꯛꯈꯔ⁰
লাকপগা	ꯂꯥꯛꯄꯒꯥ
লাকপগী	ꯂꯥꯛꯄꯒꯤ
লাকপদগী	ꯂꯥꯛꯄꯗꯒꯤ
লাকপদগীদি	ꯂꯥꯛꯄꯗꯒꯤꯗꯤ
লাকপদা	ꯂꯥꯛꯄꯗꯥ
লাকপদু	ꯂꯥꯛꯄꯗꯨ
লাকপনা	ꯂꯥꯛꯄꯅꯥ
লাকপনি	ꯂꯥꯛꯄꯅꯤ
লাকপশিং	ꯂꯥꯛꯄꯁꯤꯡ
লাকপশিংগী	ꯂꯥꯛꯄꯁꯤꯡꯒꯤ
লাকপশিংদা	ꯂꯥꯛꯄꯁꯤꯡꯗꯥ
লাকপশিংনা	ꯂꯥꯛꯄꯁꯤꯡꯅꯥ
লাকপসিদা	ꯂꯥꯛꯄꯁꯤꯗꯥ
লাকপা	ꯂꯥꯛꯄꯥ
লাকশিনবগী	ꯂꯥꯛꯁꯤꯟꯕꯒꯤ
লাকশিনবদা	ꯂꯥꯛꯁꯤꯟꯕꯗꯥ
লাকশিনবা	ꯂꯥꯛꯁꯤꯟꯕꯥ
লাকশিন্ননবা	ꯂꯥꯛꯁꯤꯟꯅꯟꯕꯥ
লাকশিন্নবগী	ꯂꯥꯛꯁꯤꯟꯅꯕꯒꯤ
লাকশিন্নবা	ꯂꯥꯛꯁꯤꯟꯅꯕꯥ
লাকশিল্লে	ꯂꯥꯛꯁꯤꯜꯂꯦ
লাকহনবা	ꯂꯥꯛꯍꯟꯕꯥ
লাকহল্লি	ꯂꯥꯛꯍꯜꯂꯤ
লাক্কদবনা	ꯂꯥꯛꯀꯗꯕꯅꯥ
লাক্কদবনি	ꯂꯥꯛꯀꯗꯕꯅꯤ
লাক্কদবা	ꯂꯥꯛꯀꯗꯕꯥ
লাক্কদ্রা	ꯂꯥꯛꯀꯗꯔꯥ
লাক্কনি	ꯂꯥꯛꯀꯅꯤ
লাক্কনু	ꯂꯥꯛꯀꯅꯨ
লাক্কে	ꯂꯥꯛꯀꯦ
লাক্নখি	ꯂꯥꯛꯅꯈꯤ
লাক্নদুনা	ꯂꯥꯛꯅꯗꯨꯅꯥ
লাক্ননবা	ꯂꯥꯛꯅꯅꯕꯥ
লাক্নবগী	ꯂꯥꯛꯅꯕꯒꯤ
লাক্নবসু	ꯂꯥꯛꯅꯕꯁꯨ
লাক্নবা	ꯂꯥꯛꯅꯕꯥ
লাক্নরি	ꯂꯥꯛꯅꯔꯤ
লাক্না	ꯂꯥꯛꯅꯥ
লাক্নিংবা	ꯂꯥꯛꯅꯤꯡꯕꯥ
লাক্লগনি	ꯂꯥꯛꯂꯒꯅꯤ
লাক্লগা	ꯂꯥꯛꯂꯒꯥ
লাক্লবদা	ꯂꯥꯀꯂ꯭ꯕꯗꯥ
লাক্লবদি	ꯂꯥꯛꯂꯕꯗꯤ
লাক্লবনি	ꯂꯥꯛꯂꯕꯅꯤꯅꯤ
লাক্লবসু	ꯂꯥꯛꯂꯕꯁꯨ
লাক্লবা	ꯂꯥꯛꯂꯕꯥ
লাক্লম্বা	ꯂꯥꯛꯂꯝꯕꯥ
লাক্লম্মী	ꯂꯥꯛꯂꯝꯃꯤ
লাক্লি	ꯂꯥꯛꯂꯤ
লাক্লিবশিং	ꯂꯥꯛꯂꯤꯕꯁꯤꯡ
লাক্লিবসি	ꯂꯥꯛꯂꯤꯕꯁꯤ
লাক্লিবা	ꯂꯥꯛꯂꯤꯕꯥ
লাক্লে	ꯂꯥꯛꯂꯦ
লাঞ্জং	ꯂꯥꯟꯖꯪ
লাঞ্জংগী	ꯂꯥꯟꯖꯪꯒꯤ
লাঞ্জংদা	ꯂꯥꯟꯖꯪꯗꯥ
লাঞ্জাও	ꯂꯥꯟꯖꯥꯖ
লান	ꯂꯥꯟ
লানখৎখিবা	ꯂꯥꯟꯈꯠꯈꯤꯕꯥ
লানগা	ꯂꯥꯟꯒꯥ
লানগী	ꯂꯥꯟꯒꯤ
লানদা	ꯂꯥꯟꯗꯥ
লানফম	ꯂꯥꯟꯐꯝ
লানফমগী	ꯂꯥꯟꯐꯝꯒꯤ
লানফমদা	ꯂꯥꯟꯐꯝꯗꯥ
লানবা	ꯂꯥꯟꯕꯥ
লানভা	ꯂꯥꯟꯚꯥ
লানশিল্লকপা	ꯂꯥꯟꯁꯤꯜꯂꯛꯄꯥ
লানা	ꯂꯥꯅꯥ
লান্থেং	ꯂꯥꯟꯊꯦꯡ
লান্থেংদা	ꯂꯥꯟꯊꯦꯡꯗꯥ
লান্থেংনখি	ꯂꯥꯟꯊꯦꯜꯅꯈꯤ
লান্থেংননবগী	ꯂꯥꯟꯊꯦꯡꯅꯟꯕꯒꯤ
লান্থেংননবা	ꯂꯥꯟꯊꯦꯡꯅꯟꯕꯥ
লান্থেংনবগী	ꯂꯥꯟꯊꯦꯡꯅꯕꯒꯤ
লান্থেংনবদা	ꯂꯥꯟꯊꯦꯡꯅꯕꯗꯥ
লান্থেংনবা	ꯂꯥꯟꯊꯦꯡꯅꯕꯥ
লান্থেংনরি	ꯂꯥꯟꯊꯦꯡꯅꯔꯤ
লান্থেংনরিবা	ꯂꯥꯟꯊꯦꯡꯅꯔꯤꯕꯥ
লান্থেংমিন্নসি	ꯂꯥꯟꯊꯦꯪꯃꯤꯟꯅꯁꯤ
লান্দা	ꯂꯥꯟꯗꯥ
লান্দাখিবা	ꯂꯥꯟꯗꯥꯈꯤꯕꯥ
লান্দানবা	ꯂꯥꯟꯗꯥꯅꯕꯥ
লান্দাবগী	ꯂꯥꯟꯗꯥꯕꯒꯤ
লান্দাবা	ꯂꯥꯟꯗꯥꯕꯥ
লান্দারকখি	ꯂꯥꯟꯗꯥꯔꯛꯈꯤ
লান্দারকপদগী	ꯂꯥꯟꯗꯥꯔꯛꯄꯗꯒꯤ
লান্দারকপা	ꯂꯥꯟꯗꯥꯔꯛꯄꯥ
লান্দুনা	ꯂꯥꯟꯗꯨꯅꯥ
লান্দে	ꯂꯥꯟꯗꯦ
লান্নবা	ꯂꯥꯟꯅꯕꯥ
লান্না	ꯂꯥꯟꯅꯥ
লান্মী	ꯂꯥꯟꯃꯤ
লান্মীগা	ꯂꯥꯟꯃꯤꯒꯥ
লান্মীগী	ꯂꯥꯟꯃꯤꯒꯤ
লান্মীদগী	ꯂꯥꯟꯃꯤꯗꯒꯤ
লান্মীদা	ꯂꯥꯟꯃꯤꯗꯥ
লান্মীশিং	ꯂꯥꯟꯃꯤꯁꯤꯡ
লান্মীশিংগী	ꯂꯥꯟꯃꯤꯁꯤꯡꯒꯤ
লাপ্ননা	ꯂꯥꯞꯅꯅꯥ
লাপ্নবা	ꯂꯥꯞꯅꯕꯥ
লাপ্না	ꯂꯥꯞꯅꯥ
লাপ্পা	ꯂꯥꯞꯄꯥ
লাবা	ꯂꯥꯕꯥ
লামাবম	ꯂꯥꯃꯥꯕꯝ
লামায়	ꯂꯥꯃꯥꯌ
লামৈ	ꯂꯥꯃꯩ
লাম্বা	ꯂꯥꯝꯕꯥ
লাম্মৈ	ꯂꯥꯝꯃꯩ
লাম্লবা	ꯂꯥꯝꯂꯕꯥ
লারবা	ꯂꯥꯔꯕꯥ
লার্জেষ্ট	ꯂꯥꯔꯖꯦꯁꯇ꯭
লার্ন	ꯂꯥꯔꯅ
লার্নিং	ꯂꯥꯔꯅꯤꯡ
লাল	ꯂꯥꯜ
লালগী	ꯂꯥꯜꯒꯤ
লালদা	ꯂꯥꯜꯗꯥ
লালা	ꯂꯥꯂꯥ
লাল্লুপ	ꯂꯥꯜꯂꯨꯄ
লাল্লে	ꯂꯥꯜꯂꯦ
লাস্কর	ꯂꯥꯁꯀ꯭ꯔ
লায়	ꯂꯥꯏ
লায়ওং	ꯂꯥꯏꯑꯣꯡ
লায়কন্নবা	ꯂꯥꯏꯀꯟꯅꯕꯥ
লায়কন্নরবা	ꯂꯥꯏꯀꯟꯅꯔꯕꯥ
লায়চৎ	ꯂꯥꯏꯆꯠ
লায়চৎকী	ꯂꯥꯏꯆꯠꯀꯤ
লায়চৎনা	ꯂꯥꯏꯆꯠꯅꯥ
লায়ন	ꯂꯥꯏꯅ
লায়না	ꯂꯥꯏꯅꯥ
লায়নাগা	ꯂꯥꯏꯅꯥꯒꯥ
লায়নাগী	ꯂꯥꯏꯅꯥꯒꯤ
লায়নাদগী	ꯂꯥꯏꯅꯥꯗꯒꯤ
লায়নানা	ꯂꯥꯏꯅꯥꯅꯥ
লায়নাশিং	ꯂꯥꯏꯅꯥꯁꯤꯡ
লায়নাশিংগী	ꯂꯥꯏꯅꯥꯁꯤꯡꯒꯤ
লায়বা	ꯂꯥꯏꯕꯥ
লায়রবা	ꯂꯥꯏꯔꯕꯥ
লায়েং	ꯂꯥꯌꯦꯡ
লায়েংখি	ꯂꯥꯌꯦꯡꯈꯤ
লায়েংগনি	ꯂꯥꯌꯦꯪꯒꯅꯤ
লায়েংগা	ꯂꯥꯌꯦꯡꯒꯥ
লায়েংগী	ꯂꯥꯌꯦꯡꯒꯤ
লায়েংগীদমক	ꯂꯥꯌꯦꯡꯒꯤꯗꯃꯛ
লায়েংদা	ꯂꯥꯌꯦꯡꯗꯥ
লায়েংদুনা	ꯂꯥꯌꯦꯪꯗꯨꯅꯥ
লায়েংনবগী	ꯂꯥꯌꯦꯡꯅꯕꯒꯤ
লায়েংনবগীদমক	ꯂꯥꯌꯦꯡꯅꯕꯒꯤꯗꯃꯛ
লায়েংনবা	ꯂꯥꯌꯦꯡꯅꯕꯥ
লায়েংফম	ꯂꯥꯌꯦꯡꯐꯝ
লায়েংবগা	ꯂꯥꯌꯦꯡꯕꯒꯥ
লায়েংবগী	ꯂꯥꯌꯦꯡꯕꯒꯤ
লায়েংবদগী	ꯂꯥꯌꯦꯡꯕꯗꯒꯤ
লায়েংবদা	ꯂꯥꯌꯦꯡꯕꯗꯥ
লায়েংবা	ꯂꯥꯌꯦꯡꯕꯥ
লায়েংলবা	ꯂꯥꯌꯦꯡꯂꯕꯥ
লায়েংলি	ꯂꯥꯌꯦꯡꯂꯤ
লায়েংলিবশিং	ꯂꯥꯌꯦꯡꯂꯤꯕꯁꯤꯡ
লায়েংলিবা	ꯂꯥꯌꯦꯡꯂꯤꯕꯥ
লায়েংশঙ	ꯂꯥꯌꯦꯡꯁꯡ
লি	ꯂꯤ
লিংখৎখি	ꯂꯤꯡꯈꯠꯈꯤ
লিংখৎখিবনি	ꯂꯤꯡꯈꯠꯈꯤꯕꯅꯤ
লিংখৎখিবা	ꯂꯤꯡꯈꯠꯈꯤꯕꯥ
লিংখৎতুনা	ꯂꯤꯪꯈꯠꯇꯨꯅꯥ
লিংখৎনবা	ꯂꯤꯡꯈꯠꯅꯕꯥ
লিংখৎপগী	ꯂꯤꯡꯡꯈꯠꯄꯒꯤ
লিংখৎপদা	ꯂꯤꯡꯈꯠꯄꯗꯥ
লিংখৎপা	ꯂꯤꯡꯈꯠꯄꯥ
লিংখৎলম্বা	ꯂꯤꯡꯈꯠꯂꯝꯕꯥ
লিংখৎলে	ꯂꯤꯡꯈꯠꯂꯦ
লিংগদবনি	ꯂꯤꯡꯒꯗꯕꯅꯤ
লিংজেল	ꯂꯤꯡꯖꯦꯜ
লিংনবা	ꯂꯤꯡꯅꯕꯥ
লিংবগী	ꯂꯤꯡꯕꯒꯤ
লিংবা	ꯂꯤꯡꯕꯥ
লিংলে	ꯂꯤꯡꯂꯦ
লিক	ꯂꯤꯀꯡꯛ
লিক্না	ꯂꯤꯛꯅꯥ
লিক্লাই	ꯂꯤꯛꯂꯥꯏ
লিক্লি	ꯂꯤꯛꯂꯤ
লিখুন	ꯂꯤꯈꯨꯅ
লিগ	ꯂꯤꯒ
লিগতা	ꯂꯤꯒꯇꯥ
লিগেল	ꯂꯤꯒꯦꯜ
লিঙ্ক	ꯂꯤꯡꯀ
লিচিং	ꯂꯤꯆꯤꯡ
লিটর	ꯂꯤꯇꯔ
লিটরেচর	ꯂꯤꯇꯔꯦꯆꯔ
লিটরেরি	ꯂꯤꯇꯔꯦꯔꯤ
লিটরেসি	ꯂꯤꯇꯔꯦꯁꯤ
লিদর	ꯂꯤꯗꯔ
লিদরশিং	ꯂꯤꯗꯔꯁꯤꯡ
লিদরশিংগা	ꯂꯤꯗꯔꯁꯤꯪꯒꯥ
লিদরশিংগী	ꯂꯤꯗꯔꯁꯤꯪꯡꯒꯤ
লিদরশিংদা	ꯂꯤꯗꯔꯁꯤꯡꯗꯥ
লিদরসিপ	ꯂꯤꯗꯔꯁꯤꯞ
লিন	ꯂꯤꯅ
লিনা	ꯂꯤꯅꯥ
লিবগী	ꯂꯤꯕꯒꯤ
লিবরেসন	ꯂꯤꯕꯔꯦꯁꯟ
লিভ	ꯂꯤꯚ
লিভিং	ꯂꯤꯚꯤꯡ
লিমিটেদ	ꯂꯤꯃꯤꯇꯦꯗ
লিমিটেদকী	ꯂꯤꯃꯤꯇꯦꯗꯀꯤ
লিরগা	ꯂꯤꯔꯒꯥ
লিরবা	ꯂꯤꯔꯕꯥ
লিরিসিস	ꯂꯤꯔꯤꯁꯤꯁ
লিলা	ꯂꯤꯂꯥ
লিলাগী	ꯂꯤꯂꯥꯒꯤ
লিলি	ꯂꯤꯂꯤ
লিশাং	ꯂꯤꯁꯥꯡ
লিশিং	ꯂꯤꯁꯤꯡ
লিশিংনা	ꯂꯤꯁꯤꯡꯅꯥ
লিষ্ট	ꯂꯤꯁꯇ꯭
লিষ্টতগী	ꯂꯤꯁꯇ꯭ꯇꯒꯤ
লিষ্টতা	ꯂꯤꯁꯇ꯭ꯇꯥ
লিষ্টনা	ꯂꯤꯁꯇ꯭ꯅꯥ
লিয়াংমৈ	ꯂꯤꯌꯥꯡꯃꯩ
লিয়াই	ꯂꯤꯌꯥꯏ
লিৱা	ꯂꯤꯋꯥ
লী	ꯂꯤ
লীংবা	ꯂꯤꯡꯕꯥ
লীক	ꯂꯤꯀ
লীক্লম	ꯂꯤꯛꯂꯝ
লীক্লা	ꯂꯤꯛꯂꯥ
লীখি	ꯂꯤꯈꯤ
লীগ	ꯂꯤꯒ
লীগকি	ꯂꯤꯒꯀꯤ
লীচিং	ꯂꯤꯆꯤꯡ
লীদুনা	ꯂꯤꯗꯨꯅꯥ
লীনা	ꯂꯤꯅꯥ
লীপুন	ꯂꯤꯄꯨꯅ
লীবা	ꯂꯤꯕꯥ
লীরবা	ꯂꯤꯔꯕꯥ
লীলা	ꯂꯤꯂꯥ
লীলাগী	ꯂꯤꯂꯥꯒꯤ
লীলানা	ꯂꯤꯂꯥꯅꯥ
লীলাশিং	ꯂꯤꯂꯥꯁꯤꯡ
লীলাশিংদা	ꯂꯤꯂꯥꯁꯤꯡꯗꯥ
লীশাং	ꯂꯤꯁꯥꯪ
লীশিং	ꯂꯤꯁꯤꯡ
লু	ꯂꯨ
লুচিংবনা	ꯂꯨꯆꯤꯪꯕꯅꯥ
লুচিংবা	ꯂꯨꯆꯤꯪꯕꯥ
লুজ	ꯂꯨꯖ
লুন	ꯂꯨꯅ
লুনা	ꯂꯨꯅꯥ
লুপ	ꯂꯨꯄ
লুপা	ꯂꯨꯄꯥ
লুপ্তুনা	ꯂꯨꯞꯇꯨꯅꯥ
লুপ্পা	ꯂꯨꯞꯄꯥ
লুবা	ꯂꯨꯕꯥ
লুম্বা	ꯂꯨꯝꯕꯥ
লুরিবদি	ꯂꯨꯔꯤꯕꯗꯤ
লুৱাং	ꯂꯨꯋꯥꯪ
লূনা	ꯂꯨꯅꯥ
লূপ	ꯂꯨꯄ
লূহুপ	ꯂꯨꯍꯨꯄ
লে	ꯂꯦ
লেংদনা	ꯂꯦꯡꯗꯅꯥ
লেংদবা	ꯂꯦꯡꯗꯕꯥ
লেংদুনা	ꯂꯦꯪꯗꯨꯅꯥ
লেংদ্রবা	ꯂꯦꯡꯗꯔꯕ
লেংয়ান	ꯂꯦꯡꯌꯥꯟ
লেক	ꯂꯦꯛ
লেকচরর	ꯂꯦꯛꯆꯔꯔ
লেঙ্গুএজ	ꯂꯦꯡꯒꯨꯑꯦꯖ
লেজিসলেচর	ꯂꯦꯖꯤꯁꯂꯦꯆꯔ
লেজিসলেচরশিংনা	ꯂꯦꯖꯤꯁꯂꯦꯆꯔꯁꯤꯡꯅꯥ
লেজিসলেটিব	ꯂꯦꯖꯤꯁꯂꯦꯇꯤꯕ
লেট	ꯂꯦꯠ
লেটর	ꯂꯦꯇꯔ
লেটরেল	ꯂꯦꯇꯔꯦꯜ
লেট্টর	ꯂꯦꯠꯇꯔ
লেদি	ꯂꯦꯗꯤ
লেন	ꯂꯦꯟ
লেনবা	ꯂꯦꯟꯕꯥ
লেনিন	ꯂꯦꯅꯤꯟ
লেনিননা	ꯂꯦꯅꯤꯟꯅꯥ
লেন্দ	ꯂꯦꯟꯗ
লেন্দগী	ꯂꯦꯟꯗꯒꯤ
লেন্দদা	ꯂꯦꯟꯗꯗꯥ
লেন্দস্লাইদ	ꯂꯦꯟꯗꯁꯂꯥꯏꯗ
লেন্দিং	ꯂꯦꯟꯗꯤꯡ
লেন্স	ꯂꯦꯟꯁ
লেপ	ꯂꯦꯞ
লেপকদবনি	ꯂꯦꯞꯀꯗꯕꯅꯤ
লেপকনি	ꯂꯦꯞꯀꯅꯤ
লেপখি	ꯂꯦꯞꯈꯤ
লেপখিবদগী	ꯂꯦꯞꯈꯤꯕꯗꯒꯤ
লেপখিবনি	ꯂꯦꯞꯈꯤꯕꯅꯤ
লেপখিবা	ꯂꯦꯞꯈꯤꯕꯥ
লেপখ্রবা	ꯂꯦꯞꯈꯔ꯭ꯕꯥ
লেপখ্রে	ꯂꯦꯞꯈꯔ⁰
লেপচনবগী	ꯂꯦꯞꯆꯟꯕꯒꯤ
লেপচবদা	ꯂꯦꯞꯆꯕꯗꯥ
লেপচবা	ꯂꯦꯞꯆꯕꯥ
লেপচসনু	ꯂꯦꯞꯆꯁꯅꯨ
লেপতনা	ꯂꯦꯞꯇꯅꯥ
লেপনখি	ꯂꯦꯞꯅꯅꯈꯤ
লেপফম	ꯂꯦꯞꯐꯝ
লেপমিন্নবা	ꯂꯦꯞꯃꯤꯟꯅꯕꯥ
লেপশিনবা	ꯂꯦꯞꯁꯤꯟꯕꯥ
লেপহনখ্রে	ꯂꯦꯞꯍꯟꯈꯔ⁰
লেপ্তনবা	ꯂꯦꯞꯇꯅꯕꯥ
লেপ্তনা	ꯂꯦꯞꯇꯅꯥ
লেপ্তুনা	ꯂꯦꯞꯇꯨꯅꯥ
লেপ্তে	ꯂꯦꯞꯇꯦ
লেপ্নখি	ꯂꯦꯞꯅꯈꯤ
লেপ্নখিবা	ꯂꯦꯞꯅꯈꯤꯕꯥ
লেপ্নখ্রে	ꯂꯦꯞꫪꯈꯔ⁰
লেপ্ননবা	ꯂꯦꯞꯅꯅꯕꯥ
লেপ্নবা	ꯂꯦꯞꯅꯕꯥ
লেপ্নরে	ꯂꯦꯞꯅꯔꯦ
লেপ্না	ꯂꯦꯞꯅꯥ
লেপ্পগী	ꯂꯦꯞꯄꯒꯤ
লেপ্পদগী	ꯂꯦꯞꯄꯗꯒꯤ
লেপ্পদা	ꯂꯦꯞꯄꯗꯥ
লেপ্পনি	ꯂꯦꯞꯄꯅꯤ
লেপ্পা	ꯂꯦꯞꯄꯥ
লেপ্পী	ꯂꯦꯞꯄꯤ
লেপ্পীখি	ꯂꯦꯞꯄꯤꯈꯤ
লেপ্লগনি	ꯂꯦꯞꯂꯒꯅꯤ
লেপ্লগা	ꯂꯦꯞꯂꯒ
লেপ্লবা	ꯂꯦꯞꯂꯕ
লেপ্লম্বা	ꯂꯦꯞꯂꯝꯕꯥ
লেপ্লরে	ꯂꯦꯄꯂ꯭ꯔꯦ
লেপ্লি	ꯂꯦꯞꯂꯤ
লেপ্লিবা	ꯂꯦꯞꯂꯤꯕꯥ
লেপ্লুরবা	ꯂꯦꯞꯂꯨꯔꯕꯥ
লেপ্লে	ꯂꯦꯞꯂꯦ
লেফট	ꯂꯦꯐꯇ
লেফটনেন্ট	ꯂꯦꯐꯇꯅꯦꯟꯇ
লেফটিনেন্ট	ꯂꯦꯐꯇꯤꯅꯦꯟꯇ
লেফ্ট	ꯂꯦꯐꯇ
লেব	ꯂꯦꯕ
লেবর	ꯂꯦꯕꯔ
লেবরগী	ꯂꯦꯕꯔꯒꯤ
লেবরশিংগী	ꯂꯦꯕꯔꯁꯤꯡꯒꯤ
লেবশিংনা	ꯂꯦꯕꯁꯤꯡꯅꯥ
লেবেল	ꯂꯦꯕꯦꯂ
লেবেলদগী	ꯂꯦꯕꯦꯜꯗꯒꯤ
লেবেলদা	ꯂꯦꯕꯦꯜꯗꯥ
লেভেল	ꯂꯦꯚꯦꯜ
লেভেলগী	ꯂꯦꯚꯦꯜꯒꯤ
লেভেলদা	ꯂꯦꯚꯦꯜꯗꯥ
লেম	ꯂꯦꯝ
লেমজদবা	ꯂꯦꯝꯖꯗꯕꯥ
লেমজনিংঙাই	ꯂꯦꯝꯖꯅꯤꯡꯉꯥꯏ
লেম্না	ꯂꯦꯝꯅꯥ
লেম্লৈ	ꯂꯦꯝꯂꯩ
লেল্লিবা	ꯂꯦꯜꯂꯤꯕꯥ
লেসন	ꯂꯦꯁꯟ
লেয়ননা	ꯂꯦꯌꯅꯅꯥ
লৈ	ꯂꯩ
লৈকাই	ꯂꯩꯀꯥꯏ
লৈকাইগী	ꯂꯩꯀꯥꯏꯒꯤ
লৈকাইদগী	ꯂꯩꯀꯥꯏꯗꯒꯤ
লৈকাইদগীনি	ꯂꯩꯀꯥꯏꯗꯒꯤꯅꯤ
লৈকাইদা	ꯂꯩꯀꯥꯏꯗꯥ
লৈকাইদুদা	ꯂꯩꯀꯥꯏꯗꯨꯗꯥ
লৈকাইনা	ꯂꯩꯀꯥꯏꯅꯥ
লৈকাইশিং	ꯂꯩꯀꯥꯏꯁꯤꯡ
লৈকাইশিংদা	ꯂꯩꯀꯥꯏꯁꯤꯡꯗꯥ
লৈকায়	ꯂꯩꯀꯥꯏ
লৈকায়গী	ꯂꯩꯀꯥꯏꯒꯤ
লৈকায়দগীনি	ꯂꯩꯀꯥꯏꯗꯒꯤꯅꯤ
লৈকায়দা	ꯂꯩꯀꯥꯏꯗꯥ
লৈকায়শিংদা	ꯂꯩꯀꯥꯏꯁꯤꯡꯗꯥ
লৈকৎ	ꯂꯩꯀꯠ
লৈখা	ꯂꯩꯈꯥ
লৈখি	ꯂꯩꯈꯤ
লৈখিগনি	ꯂꯩꯈꯤꯒꯅꯤ
লৈখিদবগা	ꯂꯩꯈꯤꯗꯕꯒꯥ
লৈখিদবগী	ꯂꯩꯈꯤꯗꯕꯒꯤ
লৈখিদবদা	ꯂꯩꯈꯤꯗꯕꯗꯥ
লৈখিদবনি	ꯂꯩꯈꯤꯗꯕꯅꯤ
লৈখিদবশিং	ꯂꯩꯈꯤꯗꯕꯁꯤꯡ
লৈখিদবা	ꯂꯩꯈꯤꯗꯕꯥ
লৈখিদে	ꯂꯩꯈꯤꯗꯦ
লৈখিদ্রবগী	ꯂꯩꯈꯤꯗꯔ꯭ꯕꯒꯤ
লৈখিদ্রবনি	ꯂꯩꯈꯤꯗꯔ꯭ꯕꯅꯤ
লৈখিদ্রবশিং	ꯂꯩꯈꯤꯗꯔ꯭ꯕꯁꯤꯡ
লৈখিদ্রবশিংগী	ꯂꯩꯈꯤꯗꯔ꯭ꯕꯁꯤꯡꯒꯤ
লৈখিদ্রবা	ꯂꯩꯈꯤꯗꯔ꯭ꯕꯥ
লৈখিদ্রবী	ꯂꯩꯈꯤꯗꯔ꯭ꯕꯤ
লৈখিদ্রবীগী	ꯂꯩꯈꯤꯗꯔ꯭ꯕꯤꯒꯤ
লৈখিদ্রে	ꯂꯩꯈꯤꯗꯔ⁰
লৈখিনি	ꯂꯩꯈꯤꯅꯤ
লৈখিবদগী	ꯂꯩꯈꯤꯕꯗꯒꯤ
লৈখিবনা	ꯂꯩꯈꯤꯕꯅꯥ
লৈখিবনি	ꯂꯩꯈꯤꯕꯅꯤ
লৈখিবা	ꯂꯩꯈꯤꯕꯥ
লৈখ্রবনি	ꯂꯩꯈꯔ꯭ꯕꯅꯤ
লৈখ্রবা	ꯂꯩꯈꯔ꯭ꯕꯥ
লৈখ্রে	ꯂꯩꯈꯔ⁰
লৈগদগে	ꯂꯩꯒꯗꯒꯦ
লৈগদবনি	ꯂꯩꯒꯗꯕꯅꯤ
লৈগদবা	ꯂꯩꯒꯗꯕꯥ
লৈগনি	ꯂꯩꯒꯅꯤ
লৈগে	ꯂꯩꯒꯦ
লৈঙাক	ꯂꯩꯉꯥꯛ
লৈঙাকনা	ꯂꯩꯉꯥꯛꯅꯥ
লৈঙাকপশিংনা	ꯂꯩꯉꯥꯛꯄꯁꯤꯡꯅꯥ
লৈঙাকপু	ꯂꯩꯉꯥꯛꯄꯨ
লৈঙাক্কী	ꯂꯩꯉꯥꯛꯀꯤ
লৈঙাক্না	ꯂꯩꯉꯥꯛꯅꯥ
লৈচিল	ꯂꯩꯆꯤꯜ
লৈজগে	ꯂꯩꯖꯒꯦ
লৈজদবা	ꯂꯩꯖꯗꯕꯥ
লৈজদুনা	ꯂꯩꯖꯗꯨꯅꯥ
লৈজদে	ꯂꯩꯖꯗꯦ
লৈজদ্রবা	ꯂꯩꯖꯗꯔ꯭ꯕꯥ
লৈজবা	ꯂꯩꯖꯕꯥ
লৈজবী	ꯂꯩꯖꯕꯤ
লৈজরক্লবা	ꯂꯩꯖꯔꯛꯂꯕꯥ
লৈজরবসু	ꯂꯩꯖꯔꯕꯁꯨ
লৈজরম্বা	ꯂꯩꯖꯔꯝꯕꯥ
লৈজরিবা	ꯂꯩꯖꯔꯤꯕꯥ
লৈজৈ	ꯂꯩꯖꯩ
লৈত	ꯂꯩꯇ
লৈতদুনা	ꯂꯩꯇꯗꯨꯅꯥ
লৈতনবা	ꯂꯩꯇꯟꯕꯥ
লৈতনা	ꯂꯩꯇꯅꯥ
লৈতবগী	ꯂꯩꯇꯕꯒꯤ
লৈতবগুম	ꯂꯩꯇꯕꯒꯨꯝ
লৈতবদগী	ꯂꯩꯇꯕꯗꯒꯤ
লৈতবদা	ꯂꯩꯇꯕꯗꯥ
লৈতবনা	ꯂꯩꯇꯕꯅꯥ
লৈতবরা	ꯂꯩꯇꯕꯔꯥ
লৈতবশিং	ꯂꯩꯇꯕꯁꯤꯡ
লৈতবা	ꯂꯩꯇꯕꯥ
লৈতব্রা	ꯂꯩꯇꯕꯔꯥ
লৈতরে	ꯂꯩꯇꯔꯦ
লৈতা	ꯂꯩꯇꯥ
লৈতাদবা	ꯂꯩꯇꯥꯗꯕꯥ
লৈতানবা	ꯂꯩꯇꯥꯅꯕꯥ
লৈতানা	ꯂꯩꯇꯥꯅꯥ
লৈতাবা	ꯂꯩꯇꯥꯕꯥ
লৈতুম	ꯂꯩꯇꯨꯃ
লৈতে	ꯂꯩꯇꯦ
লৈতেং	ꯂꯩꯇꯦꯪ
লৈতেংগা	ꯂꯩꯇꯦꯡꯒꯥ
লৈতেংগী	ꯂꯩꯇꯦꯡꯒꯤ
লৈতেংবা	ꯂꯩꯇꯦꯡꯕꯥ
লৈতেংলবা	ꯂꯩꯇꯦꯡꯂꯕꯥ
লৈদুনা	ꯂꯩꯗꯨꯅꯥ
লৈন	ꯂꯩꯅ
লৈনখি	ꯂꯩꯅꯈꯤ
লৈনখিবা	ꯂꯩꯅꯈꯤꯕꯥ
লৈনখ্রে	ꯂꯩꯅꯈꯔ⁰
লৈনদে	ꯂꯩꯅꯗꯦ
লৈননবগীদমক	ꯂꯩꯅꯅꯕꯒꯤꯗꯃꯛ
লৈননবা	ꯂꯩꯅꯅꯕꯥ
লৈননসু	ꯂꯩꯅꯅꯁꯨ
লৈননা	ꯂꯩꯅꯅꯥ
লৈনবগী	ꯂꯩꯅꯕꯒꯤ
লৈনবনা	ꯂꯩꯅꯕꯅꯥ
লৈনবশিং	ꯂꯩꯅꯕꯁꯤꯡ
লৈনবশিংগা	ꯂꯩꯅꯕꯁꯤꯡꯒꯥ
লৈনবশিংগী	ꯂꯩꯅꯕꯁꯤꯡꯒꯤ
লৈনবশিংদা	ꯂꯩꯅꯕꯁꯤꯡꯗꯥ
লৈনবশিংদি	ꯂꯩꯅꯕꯁꯤꯡꯗꯤ
লৈনবশিংনা	ꯂꯩꯅꯕꯁꯤꯡꯅꯥ
লৈনবসু	ꯂꯩꯅꯕꯁꯨ
লৈনবা	ꯂꯩꯅꯕꯥ
লৈনরকপা	ꯂꯩꯅꯔꯛꯄꯥ
লৈনরবসু	ꯂꯩꯅꯔꯕꯁꯨ
লৈনরি	ꯂꯩꯅꯔꯤ
লৈনরিবা	ꯂꯩꯅꯔꯤꯕꯥ
লৈনরে	ꯂꯩꯅꯔꯦ
লৈনা	ꯂꯩꯅꯥ
লৈনাং	ꯂꯩꯅꯥꯪ
লৈনৈ	ꯂꯩꯅꯩ
লৈপাক	ꯂꯩꯄꯥꯀ
লৈফম	ꯂꯩꯐꯝ
লৈফমদা	ꯂꯩꯐꯝꯗꯥ
লৈফমশিং	ꯂꯩꯐꯝꯁꯤꯪꯡ
লৈফমশিংদা	ꯂꯩꯐꯝꯁꯤꯡꯗꯥ
লৈব	ꯂꯩꯕ
লৈবগা	ꯂꯩꯕꯒꯥ
লৈবগী	ꯂꯩꯕꯒꯤ
লৈবগীদমক	ꯂꯩꯕꯒꯤꯗꯃꯛ
লৈবগে	ꯂꯩꯕꯒꯦ
লৈবদগী	ꯂꯩꯕꯗꯒꯤ
লৈবদসু	ꯂꯩꯕꯗꯁꯨ
লৈবদা	ꯂꯩꯕꯗꯥ
লৈবদি	ꯂꯩꯕꯗꯤ
লৈবদু	ꯂꯩꯕꯗꯨ
লৈবদুদা	ꯂꯩꯕꯗꯨꯗꯥ
লৈবনা	ꯂꯩꯕꯅꯥ
লৈবনি	ꯂꯩꯕꯅꯤ
লৈবশিং	ꯂꯩꯕꯁꯤꯪ
লৈবশিংগী	ꯂꯩꯕꯁꯤꯡꯒꯤ
লৈবশিংদা	ꯂꯩꯕꯁꯤꯡꯗꯥ
লৈবশিংনি	ꯂꯩꯕꯁꯤꯡꯅꯤ
লৈবশিংবু	ꯂꯩꯕꯁꯤꯡꯕꯨ
লৈবসি	ꯂꯩꯕꯁꯤ
লৈবসিদা	ꯂꯩꯕꯁꯤꯗꯥ
লৈবা	ꯂꯩꯕꯥ
লৈবাক	ꯂꯩꯕꯥꯛ
লৈবাকনা	ꯂꯩꯕꯥꯛꯅꯥ
লৈবাকনি	ꯂꯩꯕꯥꯛꯅꯤ
লৈবাকপু	ꯂꯩꯕꯥꯛꯄꯨ
লৈবাকশিং	ꯂꯩꯕꯥꯛꯁꯤꯡ
লৈবাকশিংগা	ꯂꯩꯕꯥꯛꯁꯤꯡꯒꯥ
লৈবাকশিংগী	ꯂꯩꯕꯥꯛꯁꯤꯡꯒꯤ
লৈবাকশিংদগী	ꯂꯩꯕꯥꯛꯁꯤꯡꯗꯒꯤ
লৈবাকশিংদসু	ꯂꯩꯕꯥꯛꯁꯤꯡꯗꯁꯨ
লৈবাকশিংদা	ꯂꯩꯕꯥꯛꯁꯤꯡꯗꯥ
লৈবাকশিংদি	ꯂꯩꯕꯥꯛꯁꯤꯡꯗꯤ
লৈবাকশিংনা	ꯂꯩꯕꯥꯛꯁꯤꯡꯅꯥ
লৈবাকসি	ꯂꯩꯕꯥꯛꯁꯤ
লৈবাকসিগী	ꯂꯩꯕꯥꯛꯁꯤꯒꯤ
লৈবাকসিদা	ꯂꯩꯕꯥꯛꯁꯤꯗꯥ
লৈবাকসিনা	ꯂꯩꯕꯥꯛꯁꯤꯅꯥ
লৈবাক্কি	ꯂꯩꯕꯥꯛꯀꯤ
লৈবাক্কী	ꯂꯩꯕꯥꯛꯀꯤ
লৈবাক্কীদমক	ꯂꯩꯕꯥꯛꯀꯤꯗꯃꯛ
লৈবাক্না	ꯂꯩꯕꯥꯛꯅꯥ
লৈবিবগে	ꯂꯩꯕꯤꯕꯒꯦ
লৈবিয়ু	ꯂꯩꯕꯤꯌꯨ
লৈবী	ꯂꯩꯕꯤ
লৈবীনবা	ꯂꯩꯕꯤꯅꯕꯥ
লৈবীয়ু	ꯂꯩꯕꯤꯌꯨ
লৈবু	ꯂꯩꯕꯨ
লৈব্রা	ꯂꯩꯕꯔꯥ
লৈমগা	ꯂꯩꯃꯒꯥ
লৈমগী	ꯂꯩꯃꯒꯤ
লৈমদা	ꯂꯩꯃꯗꯥ
লৈমনা	ꯂꯩꯃꯅꯥ
লৈমরেল	ꯂꯩꯃꯔꯦꯜ
লৈমা	ꯂꯩꯃꯥ
লৈমাইদগী	ꯂꯩꯃꯥꯏꯗꯒꯤ
লৈমায়দগী	ꯂꯩꯃꯥꯏꯗꯒꯤ
লৈমিন্নখি	ꯂꯩꯃꯤꯟꯅꯈꯤ
লৈমিন্নখ্রে	ꯂꯩꯃꯤꯟꯅꯈꯔꯦ
লৈমিন্নদুনা	ꯂꯩꯃꯤꯟꯅꯗꯨꯅꯥ
লৈমিন্নবগা	ꯂꯩꯃꯤꯟꯅꯕꯒꯥ
লৈমিন্নবগী	ꯂꯩꯃꯤꯟꯅꯕꯒꯤ
লৈমিন্নবা	ꯂꯩꯃꯤꯟꯅꯕꯥ
লৈমিন্নরগা	ꯂꯩꯃꯤꯟꯅꯔꯒꯥ
লৈমিন্নরবা	ꯂꯩꯃꯤꯟꯅꯔꯕꯥ
লৈমিন্নরিবা	ꯂꯩꯃꯤꯟꯅꯔꯤꯕꯥ
লৈমীন্নবা	ꯂꯩꯃꯤꯟꯅꯕꯥ
লৈরক	ꯂꯩꯔꯛ
লৈরকখিবনি	ꯂꯩꯔꯛꯈꯤꯕꯅꯤ
লৈরকখিবা	ꯂꯩꯔꯛꯈꯤꯕꯥ
লৈরকপগা	ꯂꯩꯔꯛꯄꯒꯥ
লৈরকপদগী	ꯂꯩꯔꯛꯄꯗꯒꯤ
লৈরকপদা	ꯂꯩꯔꯛꯄꯗꯥ
লৈরকপনা	ꯂꯩꯔꯛꯄꯅꯥ
লৈরকপনি	ꯂꯩꯔꯛꯄꯅꯤ
লৈরকপা	ꯂꯩꯔꯛꯄꯥ
লৈরকশিংদা	ꯂꯩꯔꯛꯁꯤꯡꯗꯥ
লৈরক্কদবা	ꯂꯩꯔꯛꯀꯗꯕꯥ
লৈরক্লবনি	ꯂꯩꯔꯛꯂꯕꯅꯤ
লৈরক্লবা	ꯂꯩꯔꯛꯂꯕꯥ
লৈরক্লি	ꯂꯩꯔꯛꯂꯤ
লৈরক্লিবা	ꯂꯩꯔꯛꯂꯤꯕꯥ
লৈরক্লে	ꯂꯩꯔꯛꯂꯦ
লৈরগদবনি	ꯂꯩꯔꯒꯗꯕꯅꯤ
লৈরগদি	ꯂꯩꯔꯒꯗꯤ
লৈরগনি	ꯂꯩꯔꯒꯅꯤ
লৈরগা	ꯂꯩꯔꯒꯥ
লৈরবদি	ꯂꯩꯔꯕꯗꯤ
লৈরবনি	ꯂꯩꯔꯕꯅꯤ
লৈরবনিনা	ꯂꯩꯔꯕꯅꯤꯅꯥ
লৈরবসু	ꯂꯩꯔꯕꯁꯨ
লৈরবা	ꯂꯩꯔꯕꯥ
লৈরবী	ꯂꯩꯔꯕꯤ
লৈরমখি	ꯂꯩꯔꯝꯈꯤ
লৈরমদবদু	ꯂꯩꯔꯝꯗꯕꯗꯨ
লৈরমদবা	ꯂꯩꯔꯝꯗꯕꯥ
লৈরমদে	ꯂꯩꯔꯝꯗꯦ
লৈরম্বগী	ꯂꯩꯔꯝꯕꯒꯤ
লৈরম্বদগী	ꯂꯩꯔꯝꯕꯗꯒꯤ
লৈরম্বদু	ꯂꯩꯔꯝꯕꯗꯨ
লৈরম্বনি	ꯂꯩꯔꯝꯕꯅꯤ
লৈরম্বা	ꯂꯩꯔꯝꯕꯥ
লৈরম্বী	ꯂꯩꯔꯝꯕꯤ
লৈরম্মী	ꯂꯩꯔꯝꯃꯤ
লৈরম্মে	ꯂꯩꯔꯝꯃꯦ
লৈরম্লবদি	ꯂꯩꯔꯝꯂꯕꯗꯤ
লৈরম্লবসু	ꯂꯩꯔꯝꯂꯕꯁꯨ
লৈরম্লবা	ꯂꯩꯔꯝꯂꯕꯥ
লৈরম্লিবা	ꯂꯩꯔꯝꯂꯤꯕꯥ
লৈরম্লে	ꯂꯩꯔꯝꯂꯦ
লৈরাং	ꯂꯩꯔꯥꯪ
লৈরাইদা	ꯂꯩꯔꯥꯏꯗꯥ
লৈরি	ꯂꯩꯔꯤ
লৈরিক	ꯂꯩꯔꯤꯛ
লৈরিঙৈ	ꯂꯩꯔꯤꯉꯩ
লৈরিঙৈদা	ꯂꯩꯔꯤꯉꯩꯗꯥ
লৈরিঙৈদুদা	ꯂꯩꯔꯤꯉꯩꯗꯨꯗꯥ
লৈরিবগে	ꯂꯩꯔꯤꯕꯒꯦ
লৈরিবদি	ꯂꯩꯔꯤꯕꯗꯤ
লৈরিবদু	ꯂꯩꯔꯤꯕꯗꯨ
লৈরিবনা	ꯂꯩꯔꯤꯕꯅꯥ
লৈরিবনি	ꯂꯩꯔꯤꯕꯅꯤ
লৈরিবমখৈ	ꯂꯩꯔꯤꯕꯝꯈꯩ
লৈরিবশিং	ꯂꯩꯔꯤꯕꯁꯤꯡ
লৈরিবশিংগী	ꯂꯩꯔꯤꯕꯁꯤꯡꯒꯤ
লৈরিবশিংনসু	ꯂꯩꯔꯤꯕꯁꯤꯡꯅꯁꯨ
লৈরিবশিংনা	ꯂꯩꯔꯤꯕꯁꯤꯡꯅꯥ
লৈরিবসি	ꯂꯩꯔꯤꯕꯁꯤ
লৈরিবা	ꯂꯩꯔꯤꯕꯥ
লৈরিবী	ꯂꯩꯔꯤꯕꯤ
লৈরিব্রা	ꯂꯩꯔꯤꯕꯔꯥ
লৈরুনবা	ꯂꯩꯔꯨꯅꯕꯥ
লৈরুবা	ꯂꯩꯔꯨꯕꯥ
লৈরুরবনি	ꯂꯩꯔꯨꯔꯕꯅꯤ
লৈরুরবা	ꯂꯩꯔꯨꯔꯕꯥ
লৈরুরে	ꯂꯩꯔꯨꯔꯦ
লৈরে	ꯂꯩꯔꯦ
লৈশা	ꯂꯩꯁꯥ
লৈশাংথেম	ꯂꯩꯁꯥꯡꯊꯦꯝ
লৈশাংথেমনা	ꯂꯩꯁꯥꯡꯊꯦꯝꯅꯥ
লৈশাবী	ꯂꯩꯁꯥꯕꯤ
লৈশাবীদুগী	ꯂꯩꯁꯥꯕꯤꯗꯨꯒꯤ
লৈশি	ꯂꯩꯁꯤ
লৈশিং	ꯂꯩꯁꯤꯪ
লৈশিনখিবনি	ꯂꯩꯁꯤꯅꯈꯤꯕꯅꯤ
লৈশিনবগা	ꯂꯩꯁꯤꯅꯕꯒꯥ
লৈশিনবগী	ꯂꯩꯁꯤꯅꯕꯒꯤ
লৈশিনবা	ꯂꯩꯁꯤꯅꯕꯥ
লৈশিন্দুনা	ꯂꯩꯁꯤꯟꯗꯨꯅꯥ
লৈশিন্নবা	ꯂꯩꯁꯤꯟꯅꯕꯥ
লৈশিল্লিবা	ꯂꯩꯁꯤꯜꯂꯤꯕꯥ
লৈশিল্লে	ꯂꯩꯁꯤꯜꯂꯦ
লৈশেম্বদা	ꯂꯩꯁꯦꯝꯕꯗꯥ
লৈশেম্বনা	ꯂꯩꯁꯦꯝꯕꯅꯥ
লৈশেম্বা	ꯂꯩꯁꯦꯝꯕꯥ
লৈহনখিদবা	ꯂꯩꯍꯟꯈꯤꯗꯕꯥ
লৈহনগদগে	ꯂꯩꯍꯟꯒꯗꯒꯦ
লৈহনগদবনি	ꯂꯩꯍꯟꯒꯗꯕꯅꯤ
লৈহনদ্রে	ꯂꯩꯍꯟꯗꯔ⁰
লৈহনবগী	ꯂꯩꯍꯟꯕꯒꯤ
লৈহনবতা	ꯂꯩꯍꯟꯕꯇꯥ
লৈহনবনি	ꯂꯩꯍꯟꯕꯅꯤ
লৈহনবা	ꯂꯩꯍꯟꯕꯥ
লৈহনসি	ꯂꯩꯍꯟꯁꯤ
লৈহন্দনবা	ꯂꯩꯍꯟꯗꯅꯕꯥ
লৈহন্দবা	ꯂꯩꯍꯟꯗꯕꯥ
লৈহন্ননবা	ꯂꯩꯍꯟꯅꯅꯕꯥ
লৈহন্নবগী	ꯂꯩꯍꯟꯅꯕꯒꯤ
লৈহন্নবা	ꯂꯩꯍꯟꯅꯕꯥ
লৈহল্লি	ꯂꯩꯍꯜꯂꯤ
লৈহল্লে	ꯂꯩꯍꯜꯂꯦ
লৈহাও	ꯂꯩꯍꯥꯎ
লৈহাওদগী	ꯂꯩꯍꯥꯑꯣꯎꯒꯤ
লৈহাওদা	ꯂꯩꯍꯥꯎꯗꯥ
লৱার	ꯂꯋꯥꯏ
শং	ꯁꯪ
শংলাকপম	ꯁꯪꯂꯥꯛꯄꯝ
শংলেনদা	ꯁꯪꯂꯦꯟꯗꯥ
শক	ꯁꯛ
শকখঙদবশিংনা	ꯁꯛꯈꯡꯗꯕꯁꯤꯡꯅꯥ
শকখঙদবা	ꯁꯛꯈꯡꯗꯕꯥ
শকখঙনরবা	ꯁꯛꯈꯡꯅꯔꯕꯥ
শকখঙবা	ꯁꯛꯈꯡꯕꯥ
শকখঙলবা	ꯁꯛꯈꯡꯂꯕꯥ
শকখি	ꯁꯛꯈꯤ
শকখিবা	ꯁꯛꯈꯤꯕꯥ
শকপদা	ꯁꯛꯄꯗꯥ
শকপনি	ꯁꯛꯄꯅꯤ
শকপা	ꯁꯛꯄꯥ
শকমিন্নবা	ꯁꯛꯃꯤꯟꯅꯕꯥ
শক্নাইবা	ꯁꯛꯅꯥꯏꯕꯥ
শক্নাইরবশিং	ꯁꯛꯅꯥꯏꯔꯕꯁꯤꯡ
শক্নাইরবা	ꯁꯛꯅꯥꯏꯔꯕꯥ
শক্নাইরবী	ꯁꯛꯅꯥꯏꯔꯕꯤ
শখি	ꯁꯈꯤ
শঙ	ꯁꯡ
শঙম	ꯁꯉꯝ
শঙলূপ	ꯁꯡꯂꯨꯄ
শঙলেন	ꯁꯡꯂꯦꯟ
শঙলেনদা	ꯁꯡꯂꯦꯟꯗꯥ
শঙলেন্দা	ꯁꯡꯂꯦꯟꯗꯥ
শঙাই	ꯁꯉꯥꯏ
শঙাইথেলদা	ꯁꯉꯥꯏꯊꯦꯜꯗꯥ
শঙ্কর	ꯁꯡꯀꯔ
শঙ্গাখি	ꯁꯡꯒꯥꯈꯤ
শঙ্গাখ্রে	ꯁꯡꯒꯥꯈꯔ⁰
শঙ্গাবা	ꯁꯡꯒꯥꯕꯥ
শঙ্গু	ꯁꯡꯒꯨ
শজি	ꯁꯖꯤ
শজিক	ꯁꯖꯤꯛ
শজিবু	ꯁꯖꯤꯕꯨ
শজিৱাদা	ꯁꯖꯤꯋꯥꯗꯥ
শন	ꯁꯟ
শনৈবী	ꯁꯅꯩꯕꯤ
শন্না	ꯁꯟꯅꯥ
শবি	ꯁꯕꯤ
শম	ꯁꯝ
শমু	ꯁꯃꯨ
শম্নখিবা	ꯁꯝꯅꯈꯤꯕꯥ
শম্নগদবা	ꯁꯝꯅꯒꯗꯕꯥ
শম্নদনা	ꯁꯝꯅꯗꯅꯥ
শম্ননবা	ꯁꯝꯅꯅꯕꯥ
শম্ননা	ꯁꯝꯅꯅꯥ
শম্নবগী	ꯁꯝꯅꯕꯒꯤ
শম্নবা	ꯁꯝꯅꯕꯥ
শম্নরম্বা	ꯁꯝꯅꯔꯝꯕꯥ
শম্নরুবদগী	ꯁꯝꯅꯔꯨꯕꯗꯒꯤ
শম্নরুবা	ꯁꯝꯅꯔꯨꯕꯥ
শম্না	ꯁꯝꯅꯥ
শম্বল	ꯁꯝꯕꯜ
শরং	ꯁꯔꯡ
শরত	ꯁꯔꯠ
শরিক	ꯁꯔꯤꯛ
শরিফ	ꯁꯔꯤꯐ
শরু	ꯁꯔꯨ
শরুক	ꯁꯔꯨꯛ
শরুকশিং	ꯁꯔꯨꯛꯁꯤꯡ
শরুকশিংদা	ꯁꯔꯨꯛꯁꯤꯡꯗꯥ
শরুক্কী	ꯁꯔꯨꯛꯀꯤ
শরুক্না	ꯁꯔꯨꯛꯅꯥ
শরুনি	ꯁꯔꯨꯅꯤ
শরূক	ꯁꯔꯨꯀ
শরূদা	ꯁꯔꯨꯗꯥ
শা	ꯁꯥ
শাংই	ꯁꯥꯡꯏ
শাংগনি	ꯁꯥꯡꯒꯅꯤ
শাংনদগী	ꯁꯥꯡꯅꯗꯒꯤ
শাংনা	ꯁꯥꯡꯅꯥ
শাংবা	ꯁꯥꯡꯕꯥ
শাংলবা	ꯁꯥꯡꯂꯕꯥ
শাই	ꯁꯥꯏ
শাইজিন	ꯁꯥꯏꯖꯤꯅ
শাওদুনা	ꯁꯥꯑꯣꯗꯨꯅꯥ
শাখি	ꯁꯥꯈꯤ
শাখিবনি	ꯁꯥꯈꯤꯕꯅꯤ
শাখিবা	ꯁꯥꯈꯤꯕꯥ
শাখ্রে	ꯁꯥꯈꯔꯦ
শাগদবনি	ꯁꯥꯒꯗꯕꯅꯤ
শাগদবা	ꯁꯥꯒꯗꯕꯥ
শাগনি	ꯁꯥꯒꯅꯤ
শাগী	ꯁꯥꯒꯤ
শাগৈ	ꯁꯥꯒꯩ
শাগৈগী	ꯁꯥꯒꯩꯒꯤ
শাগৎখি	ꯁꯥꯒꯠꯈꯤ
শাগৎচরম্বা	ꯁꯥꯒꯠꯆꯔꯝꯕꯥ
শাগৎতুনা	ꯁꯥꯒꯠꯇꯨꯅꯥ
শাগৎনবগী	ꯁꯥꯒꯠꯅꯕꯒꯤ
শাগৎনবগীদমক	ꯁꯥꯒꯠꯅꯕꯒꯤꯗꯃꯛ
শাগৎনবা	ꯁꯥꯒꯠꯅꯕꯥ
শাগৎপগী	ꯁꯥꯒꯠꯄꯒꯤ
শাগৎপদা	ꯁꯥꯒꯠꯄꯗꯥ
শাগৎপা	ꯁꯥꯒꯠꯄꯥ
শাগৎলবদি	ꯁꯥꯒꯠꯂꯕꯗꯤ
শাগৎলম্বা	ꯁꯥꯒꯠꯂꯝꯕꯥ
শাগৎলিবশিং	ꯁꯥꯒꯠꯂꯤꯕꯁꯤꯡ
শাগৎলিবা	ꯁꯥꯒꯠꯂꯤꯕꯥ
শাঙাঙ	ꯁꯥꯉꯥꯉ
শাজবা	ꯁꯥꯖꯕꯥ
শাজাওবা	ꯁꯥꯖꯥꯑꯣꯕꯥ
শাজিনবগী	ꯁꯥꯖꯤꯟꯕꯒꯤ
শাজিনবা	ꯁꯥꯖꯤꯟꯕꯥ
শাজিন্নবা	ꯁꯥꯖꯤꯟꯅꯕꯥ
শাজেল	ꯁꯥꯖꯦꯜ
শাজৎ	ꯁꯥꯖꯠ
শাজৎকী	ꯁꯥꯖꯠꯀꯤ
শাজৎনা	ꯁꯥꯖꯠꯅꯥ
শাথি	ꯁꯥꯊꯤ
শাথিনা	ꯁꯥꯊꯤꯅꯥ
শাথিবা	ꯁꯥꯊꯤꯕꯥ
শাথিরবা	ꯁꯥꯊꯤꯔꯕꯥ
শাথীনা	ꯁꯥꯊꯤꯅꯥ
শাদগীসু	ꯁꯥꯗꯒꯤꯁꯨ
শাদুনা	ꯁꯥꯗꯨꯅꯥ
শাদ্রিবা	ꯁꯥꯗꯔꯤꯕꯥ
শানখি	ꯁꯥꯅꯈꯤ
শানদুনা	ꯁꯥꯅꯗꯨꯅꯥ
শাননবা	ꯁꯥꯅꯅꯕꯥ
শানবগী	ꯁꯥꯅꯕꯒꯤ
শানবগীদমক	ꯁꯥꯅꯕꯒꯤꯗꯃꯛ
শানবদগী	ꯁꯥꯅꯕꯗꯒꯤ
শানবসু	ꯁꯥꯅꯕꯁꯨ
শানবা	ꯁꯥꯅꯕꯥ
শানা	ꯁꯥꯅꯥ
শান্তনা	ꯁꯥꯟꯇꯅꯥ
শান্তি	ꯁꯥꯟꯇꯤ
শান্তিকুমার	ꯁꯥꯟꯇꯤꯀꯨꯃꯥꯔ
শান্তিগী	ꯁꯥꯟꯇꯤꯒꯤ
শান্তিবলা	ꯁꯥꯟꯇꯤꯕꯂꯥ
শান্ন	ꯁꯥꯟꯅ
শান্নখি	ꯁꯥꯟꯅꯈꯤ
শান্নখিগনি	ꯁꯥꯟꯅꯈꯤꯒꯅꯤ
শান্নখিবদা	ꯁꯥꯟꯅꯈꯤꯕꯗꯥ
শান্নখিবা	ꯁꯥꯟꯅꯈꯤꯕꯥ
শান্নখ্রবনি	ꯁꯥꯟꯅꯈꯔ꯭ꯕꯅꯤ
শান্নখ্রবা	ꯁꯥꯟꯅꯈꯔ꯭ꯕꯥ
শান্নখ্রে	ꯁꯥꯟꯅꯈꯔꯦ
শান্নগদবনি	ꯁꯥꯟꯅꯒꯗꯕꯅꯤ
শান্নগদবা	ꯁꯥꯟꯅꯒꯗꯕꯥ
শান্নগনি	ꯁꯥꯟꯅꯒꯅꯤ
শান্নদুনা	ꯁꯥꯟꯅꯗꯨꯅꯥ
শান্ননবা	ꯁꯥꯟꯅꯟꯕꯥ
শান্নফম	ꯁꯥꯟꯅꯐꯝ
শান্নফমদা	ꯁꯥꯟꯅꯐꯝꯗꯥ
শান্নফমশিং	ꯁꯥꯟꯅꯐꯝꯁꯤꯡ
শান্নবগা	ꯁꯥꯟꯅꯕꯒꯥ
শান্নবগী	ꯁꯥꯟꯅꯕꯒꯤ
শান্নবদগী	ꯁꯥꯟꯅꯕꯗꯒꯤ
শান্নবদা	ꯁꯥꯟꯅꯕꯗꯥ
শান্নবনা	ꯁꯥꯟꯅꯕꯅꯥ
শান্নবনি	ꯁꯥꯟꯅꯕꯅꯤ
শান্নববু	ꯁꯥꯟꯅꯕꯕꯨ
শান্নবা	ꯁꯥꯟꯅꯕꯥ
শান্নবুংশিং	ꯁꯥꯟꯅꯕꯨꯡꯁꯤꯡ
শান্নরকপা	ꯁꯥꯟꯅꯔꯛꯄ
শান্নরগনি	ꯁꯥꯟꯅꯔꯒꯅꯤ
শান্নরগা	ꯁꯥꯟꯅꯔꯒ
শান্নরবসু	ꯁꯥꯟꯅꯔꯕꯁꯨ
শান্নরবা	ꯁꯥꯟꯅꯔꯕ
শান্নরম্বদগী	ꯁꯥꯟꯅꯔꯝꯕꯗꯒꯤ
শান্নরম্বা	ꯁꯥꯟꯅꯔꯝꯕ
শান্নরম্মী	ꯁꯥꯟꯅꯔꯝꯃꯤ
শান্নরি	ꯁꯥꯟꯅꯔꯤ
শান্নরিঙৈদা	ꯁꯥꯟꯅꯔꯤꯉꯩꯗ
শান্নরিবা	ꯁꯥꯟꯅꯔꯤꯕ
শান্নরে	ꯁꯥꯟꯅꯔꯦ
শান্নসি	ꯁꯥꯟꯅꯁꯤ
শান্না	ꯁꯟꯅ
শান্নৈ	ꯁꯥꯟꯅꯩ
শাফগদবা	ꯁꯥꯐꯒꯗꯕ
শাফবা	ꯁꯥꯐꯕ
শাফবী	ꯁꯥꯐꯕꯤ
শাফম	ꯁꯥꯐꯝ
শাফরগনি	ꯁꯥꯐꯔꯒꯅꯤ
শাফু	ꯁꯥꯐꯨ
শাফুগা	ꯁꯥꯐꯨꯒ
শাবগা	ꯁꯥꯕꯒ
শাবগী	ꯁꯥꯕꯒꯤ
শাবতা	ꯁꯥꯕꯇ
শাবদা	ꯁꯥꯕꯗ
শাবনা	ꯁꯥꯕꯅ
শাবনি	ꯁꯥꯕꯅꯤ
শাবল	ꯁꯥꯕꯜ
শাবসু	ꯁꯥꯕꯁꯨ
শাবা	ꯁꯥꯕ
শাবিদুনা	ꯁꯥꯕꯤꯗꯨꯅꯥ
শাবিবা	ꯁꯥꯕꯤꯕꯥ
শাবী	ꯁꯥꯕꯤ
শাবীনবা	ꯁꯥꯕꯤꯅꯕ
শাবীশিংগী	ꯁꯥꯕꯤꯁꯤꯡꯒꯤ
শামি	ꯁꯥꯃꯤ
শামু	ꯁꯥꯃꯨ
শারক্লে	ꯁꯥꯔꯛꯂꯦ
শারগনি	ꯁꯥꯔꯒꯅꯤ
শারগা	ꯁꯥꯔꯒ
শারবা	ꯁꯥꯔꯕ
শারম	ꯁꯥꯔꯝ
শারম্বা	ꯁꯥꯔꯝꯕꯥ
শারম্বী	ꯁꯥꯔꯝꯕꯤ
শারি	ꯁꯥꯔꯤ
শারিবশিং	ꯁꯥꯔꯤꯕꯁꯤꯡ
শারিবা	ꯁꯥꯔꯤꯕ
শারিয়ে	ꯁꯥꯔꯤꯌꯦ
শারে	ꯁꯥꯔꯦ
শাশিং	ꯁꯥꯁꯤꯡ
শাশিন্নবা	ꯁꯥꯁꯤꯟꯅꯕ
শাসন	ꯁꯥꯁꯟ
শাসনগী	ꯁꯥꯁꯟꯒꯤ
শাহল্লি	ꯁꯥꯍꯜꯂꯤ
শাহল্লে	ꯁꯥꯍꯜꯂꯦ
শাহিং	ꯁꯥꯍꯤꯪ
শাৎপা	ꯁꯥꯠꯄ
শি	ꯁꯤ
শিং	ꯁꯤꯡ
শিংই	ꯁꯤꯡꯏ
শিংগা	ꯁꯤꯪꯒꯥ
শিংগী	ꯁꯤꯡꯒꯤ
শিংগৎপগী	ꯁꯤꯡꯒꯠꯄꯒꯤ
শিংজমৈ	ꯁꯤꯡꯖꯃꯩ
শিংজমৈগী	ꯁꯤꯡꯖꯃꯩꯒꯤ
শিংজমৈদগী	ꯁꯤꯡꯖꯃꯩꯗꯒꯤ
শিংজমৈদা	ꯁꯤꯡꯖꯃꯩꯗ
শিংথাখি	ꯁꯤꯡꯊꯥꯈꯤ
শিংথানরিবা	ꯁꯤꯡꯊꯥꯅꯔꯤꯕ
শিংথানিংঙাই	ꯁꯤꯡꯊꯥꯅꯤꯡꯉꯥꯏ
শিংথানিংঙাইনি	ꯁꯤꯡꯊꯥꯅꯤꯡꯉꯥꯏꯅꯤ
শিংথাবগা	ꯁꯤꯡꯊꯥꯕꯒ
শিংথাবা	ꯁꯤꯡꯊꯥꯕ
শিংথারদুনা	ꯁꯤꯡꯊꯥꯔꯗꯨꯅ
শিংথারি	ꯁꯤꯡꯊꯥꯔꯤ
শিংদা	ꯁꯤꯡꯗ
শিংদে	ꯁꯤꯡꯗꯦ
শিংনখিবা	ꯁꯤꯡꯅꯈꯤꯕ
শিংনদুনা	ꯁꯤꯡꯅꯗꯨꯅ
শিংনবনি	ꯁꯤꯡꯅꯕꯅꯤ
শিংনবশিং	ꯁꯤꯡꯅꯕꯁꯤꯡ
শিংনবা	ꯁꯤꯡꯅꯕ
শিংনরদুনা	ꯁꯤꯡꯅꯔꯗꯨꯅ
শিংনরিবা	ꯁꯤꯡꯅꯔꯤꯕ
শিংনা	ꯁꯤꯡꯅ
শিংবগী	ꯁꯤꯡꯕꯒꯤ
শিংবশিং	ꯁꯤꯡꯕꯁꯤꯡ
শিংবা	ꯁꯤꯡꯕ
শিংবু	ꯁꯤꯪꯕꯨ
শিংলবা	ꯁꯤꯡꯂꯕ
শিংলি	ꯁꯤꯡꯂꯤ
শিখাঙ	ꯁꯤꯈꯥꯉ
শিখি	ꯁꯤꯈꯤ
শিখিদুনা	ꯁꯤꯈꯤꯗꯨꯅ
শিখিদে	ꯁꯤꯈꯤꯗꯦ
শিখিদ্রে	ꯁꯤꯈꯤꯗꯔꯦ
শিখিবগা	ꯁꯤꯈꯤꯕꯒ
শিখিবগী	ꯁꯤꯈꯤꯕꯒꯤ
শিখিবনা	ꯁꯤꯈꯤꯕꯅ
শিখিবনি	ꯁꯤꯈꯤꯕꯅꯤ
শিখিবশিং	ꯁꯤꯈꯤꯕꯁꯤꯡ
শিখিবশিংগী	ꯁꯤꯈꯤꯕꯁꯤꯡꯒꯤ
শিখিবা	ꯁꯤꯈꯤꯕ
শিখ্রবা	ꯁꯤꯈ꯭ꯔꯕ
শিখ্রে	ꯁꯤꯈ꯭ꯔꯦ
শিগদবদগী	ꯁꯤꯒꯗꯕꯗꯒꯤ
শিগনি	ꯁꯤꯒꯅꯤ
শিজ	ꯁꯤꯖ
শিজবগী	ꯁꯤꯖꯕꯒꯤ
শিজবা	ꯁꯤꯖꯕ
শিজিন্নখি	ꯁꯤꯖꯤꯟꯅꯈꯤ
শিজিন্নগদগে	ꯁꯤꯖꯤꯟꯅꯒꯗꯒꯦ
শিজিন্নগদবনি	ꯁꯤꯖꯤꯟꯅꯒꯗꯕꯅꯤ
শিজিন্নগনি	ꯁꯤꯖꯤꯟꯅꯒꯅꯤ
শিজিন্নদুনা	ꯁꯤꯖꯤꯟꯅꯗꯨꯅ
শিজিন্ননবসু	ꯁꯤꯖꯤꯟꯅꯅꯕꯁꯨ
শিজিন্ননবা	ꯁꯤꯖꯤꯟꯅꯅꯕ
শিজিন্ননিংবা	ꯁꯤꯖꯤꯟꯅꯅꯤꯡꯕ
শিজিন্নবগা	ꯁꯤꯖꯤꯟꯅꯕꯒ
শিজিন্নবগী	ꯁꯤꯖꯤꯟꯅꯕꯒꯤ
শিজিন্নবদা	ꯁꯤꯖꯤꯟꯅꯕꯗ
শিজিন্নবনা	ꯁꯤꯖꯤꯟꯅꯕꯅ
শিজিন্নবনি	ꯁꯤꯖꯤꯟꯅꯕꯅꯤ
শিজিন্নবা	ꯁꯤꯖꯤꯟꯅꯕ
শিজিন্নরকপনা	ꯁꯤꯖꯤꯟꯅꯔꯛꯄꯅ
শিজিন্নরগা	ꯁꯤꯖꯤꯟꯅꯔꯒ
শিজিন্নরবদি	ꯁꯤꯖꯤꯟꯅꯔꯕꯗꯤ
শিজিন্নরম্বা	ꯁꯤꯖꯤꯟꯅꯔꯝꯕ
শিজিন্নরি	ꯁꯤꯖꯤꯟꯅꯔꯤ
শিজিন্নরিবা	ꯁꯤꯖꯤꯟꯅꯔꯤꯕ
শিথরকপগী	ꯁꯤꯊꯔꯛꯄꯒꯤ
শিদবা	ꯁꯤꯗꯕ
শিদবী	ꯁꯤꯗꯕꯤ
শিদুনা	ꯁꯤꯗꯨꯅ
শিদ্রি	ꯁꯤꯗꯔꯤ
শিন	ꯁꯤꯟ
শিনখি	ꯁꯤꯟꯈꯤ
শিনগদবনি	ꯁꯤꯟꯒꯗꯕꯅꯤ
শিনগনি	ꯁꯤꯟꯒꯅꯤ
শিনফম	ꯁꯤꯟꯐꯝ
শিনফমগী	ꯁꯤꯟꯐꯝꯒꯤ
শিনফমদা	ꯁꯤꯟꯐꯝꯗ
শিনফমশিং	ꯁꯤꯟꯐꯝꯁꯤꯡ
শিনবগী	ꯁꯤꯟꯕꯒꯤ
শিনবনি	ꯁꯤꯟꯕꯅꯤ
শিনবা	ꯁꯤꯟꯕ
শিনবীয়ু	ꯁꯤꯟꯕꯤꯌꯨ
শিনা	ꯁꯤꯅꯥ
শিন্থা	ꯁꯤꯟꯊꯥ
শিন্দম	ꯁꯤꯟꯗꯝ
শিন্দুনা	ꯁꯤꯟꯗꯨꯅꯥ
শিন্নখি	ꯁꯤꯟꯅꯈꯤ
শিন্নখিবনি	ꯁꯤꯟꯅꯈꯤꯕꯅꯤ
শিন্নখিবা	ꯁꯤꯟꯅꯈꯤꯕ
শিন্নখ্রে	ꯁꯤꯟꯅꯈꯔꯦ
শিন্নগদবনি	ꯁꯤꯟꯅꯒꯗꯕꯅꯤ
শিন্নগনি	ꯁꯤꯟꯅꯒꯅꯤ
শিন্নজরি	ꯁꯤꯟꯅꯖꯔꯤ
শিন্নদুনা	ꯁꯤꯟꯅꯗꯨꯅ
শিন্ননবা	ꯁꯤꯟꯅꯅꯕ
শিন্নবগা	ꯁꯤꯟꯅꯕꯒ
শিন্নবগী	ꯁꯤꯟꯅꯕꯒꯤ
শিন্নবগীদমক	ꯁꯤꯟꯅꯕꯒꯤꯗꯃꯛ
শিন্নবা	ꯁꯤꯟꯅꯕ
শিন্নরকপা	ꯁꯤꯟꯅꯔꯛꯄ
শিন্নরক্লিবা	ꯁꯤꯟꯅꯔꯛꯂꯤꯕ
শিন্নরগনি	ꯁꯤꯟꯅꯔꯒꯅꯤ
শিন্নরগা	ꯁꯤꯟꯅꯔꯒꯥ
শিন্নরবদি	ꯁꯤꯟꯅꯔꯕꯗꯤ
শিন্নরমদুনা	ꯁꯤꯟꯅꯔꯝꯗꯨꯅ
শিন্না	ꯁꯤꯟꯅꯥ
শিন্নৈ	ꯁꯤꯟꯅꯩ
শিন্মী	ꯁꯤꯟꯃꯤ
শিন্মীশিং	ꯁꯤꯟꯃꯤꯁꯤꯡ
শিন্মীশিংগী	ꯁꯤꯟꯃꯤꯁꯤꯡꯒꯤ
শিন্মীশিংদা	ꯁꯤꯟꯃꯤꯁꯤꯡꯗ
শিন্মীশিংনা	ꯁꯤꯟꯃꯤꯁꯤꯡꯅ
শিন্মীশিংবু	ꯁꯤꯟꯃꯤꯁꯤꯡꯕꯨ
শিব	ꯁꯤꯕ
শিবগা	ꯁꯤꯕꯒ
শিবগী	ꯁꯤꯕꯒꯤ
শিবদগী	ꯁꯤꯕꯗꯒꯤ
শিবদা	ꯁꯤꯕꯗꯥ
শিবনা	ꯁꯤꯕꯅ
শিবনি	ꯁꯤꯕꯅꯤ
শিববু	ꯁꯤꯕꯕꯨ
শিবরাজ	ꯁꯤꯕꯔꯥꯖ
শিবসু	ꯁꯤꯕꯁꯨ
শিবা	ꯁꯤꯕ
শিবু	ꯁꯤꯕꯨ
শিম	ꯁꯤꯝ
শিমলাদা	ꯁꯤꯝꯂꯥꯗ
শিরকপদগী	ꯁꯤꯔꯛꯄꯗꯒꯤ
শিরকপা	ꯁꯤꯔꯛꯄ
শিরক্লি	ꯁꯤꯔꯛꯂꯤ
শিরক্লিবা	ꯁꯤꯔꯛꯂꯤꯕ
শিরগনি	ꯁꯤꯔꯒꯅꯤ
শিরগা	ꯁꯤꯔꯒ
শিরদুনা	ꯁꯤꯔꯗꯨꯅ
শিরবদি	ꯁꯤꯔꯕꯗꯤ
শিরবসু	ꯁꯤꯔꯕꯁꯨ
শিরবা	ꯁꯤꯔꯕ
শিরম্বগী	ꯁꯤꯔꯝꯕꯒꯤ
শিরি	ꯁꯤꯔꯤ
শিরিবা	ꯁꯤꯔꯤꯕꯥ
শিরুই	ꯁꯤꯔꯨꯏ
শিরে	ꯁꯤꯔꯦ
শিল	ꯁꯤꯜ
শিলচর	ꯁꯤꯜꯆꯔ
শিলচরদা	ꯁꯤꯜꯆꯔꯗ
শিল্লগা	ꯁꯤꯜꯂꯒ
শিল্লবা	ꯁꯤꯜꯂꯕꯥ
শিল্লি	ꯁꯤꯜꯂꯤ
শিল্লিবশিং	ꯁꯤꯜꯂꯤꯕꯁꯤꯡ
শিল্লিবা	ꯁꯤꯜꯂꯤꯕ
শিল্লে	ꯁꯤꯜꯂꯦ
শিহনখিবা	ꯁꯤꯍꯟꯈꯤꯕ
শিহনখ্রবা	ꯁꯤꯍꯟꯈ꯭ꯔꯕ
শিহনখ্রে	ꯁꯤꯍꯟꯈꯔꯦ
শিহনবগী	ꯁꯤꯍꯟꯕꯒꯤ
শিহল্লবা	ꯁꯤꯍꯜꯂꯕꯥ
শিৎ	ꯁꯤꯠ
শিৎনা	ꯁꯤꯠꯅ
শিৎপগী	ꯁꯤꯠꯄꯒꯤ
শিৎপা	ꯁꯤꯠꯄ
শিৎলকপা	ꯁꯤꯠꯂꯛꯄ
শিৎলি	ꯁꯤꯠꯂꯤ
শীং	ꯁꯤꯪ
শীংজমৈ	ꯁꯤꯪꯖꯃꯩ
শীংনরক্লিবা	ꯁꯤꯪꯅꯔꯛꯂꯤꯕꯥ
শীংনরি	ꯁꯤꯪꯅꯔꯤ
শীখি	ꯁꯤꯈꯤ
শীজিন্নখিবা	ꯁꯤꯖꯤꯟꯅꯈꯤꯕꯥ
শীজিন্নদবা	ꯁꯤꯖꯤꯟꯅꯗꯕꯥ
শীজিন্নদুনা	ꯁꯤꯖꯤꯟꯅꯗꯨꯅꯥ
শীজিন্ননবা	ꯁꯤꯖꯤꯟꯅꯟꯕꯥ
শীজিন্নবগী	ꯁꯤꯖꯤꯟꯅꯕꯒꯤ
শীজিন্নবা	ꯁꯤꯖꯤꯟꯅꯕꯥ
শীদুনা	ꯁꯤꯗꯨꯅꯥ
শীনবা	ꯁꯤꯅꯕꯥ
শীন্দুনা	ꯁꯤꯟꯗꯨꯅꯥ
শীরি	ꯁꯤꯔꯤ
শীরে	ꯁꯤꯔꯦ
শীল	ꯁꯤꯂ
শু	ꯁꯨ
শুংনবগী	ꯁꯨꯡꯅꯕꯒꯤ
শুংফম	ꯁꯨꯡꯐꯝ
শুংবগী	ꯁꯨꯡꯕꯒꯤ
শুংবদা	ꯁꯨꯡꯕꯗ
শুংবা	ꯁꯨꯡꯕ
শুক	ꯁꯨꯀ
শুকখঙ	ꯁꯨꯛꯈꯡ
শুক্লবা	ꯁꯨꯀꯂ꯭ꯕꯥ
শুক্লৈ	ꯁꯨꯛꯂꯩ
শুকয়া	ꯁꯨꯛꯌꯥ
শুখিবগা	ꯁꯨꯈꯤꯕꯒ
শুখিবা	ꯁꯨꯈꯤꯕ
শুখ্রবা	ꯁꯨꯈ꯭ꯔꯕ
শুখ্রে	ꯁꯨꯈ꯭ꯔꯦ
শুগদবা	ꯁꯨꯒꯗꯕ
শুগনি	ꯁꯨꯒꯅꯤ
শুগাইনা	ꯁꯨꯒꯥꯏꯅ
শুদনা	ꯁꯨꯗꯅ
শুদুনা	ꯁꯨꯗꯨꯅ
শুনবা	ꯁꯨꯅꯕ
শুনা	ꯁꯨꯅꯥ
শুনু	ꯁꯨꯅꯨ
শুপ্নগী	ꯁꯨꯞꯅꯒꯤ
শুপ্নতগী	ꯁꯨꯞꯅꯇꯒꯤ
শুপ্না	ꯁꯨꯞꯅ
শুফম	ꯁꯨꯐꯝ
শুফমদা	ꯁꯨꯐꯝꯗ
শুফমশিং	ꯁꯨꯐꯝꯁꯤꯡ
শুবগা	ꯁꯨꯕꯒ
শুবগী	ꯁꯨꯕꯒꯤ
শুবদা	ꯁꯨꯕꯗ
শুবনি	ꯁꯨꯕꯅꯤ
শুবা	ꯁꯨꯕ
শুম	ꯁꯨꯃ
শুমাং	ꯁꯨꯃꯥꯡ
শুমাঙ	ꯁꯨꯃꯥꯉ
শুরকপগা	ꯁꯨꯔꯛꯄꯒ
শুরকপদগী	ꯁꯨꯔꯛꯄꯗꯒꯤ
শুরকপদা	ꯁꯨꯔꯛꯄꯗ
শুরকপা	ꯁꯨꯔꯛꯄ
শুরক্লবা	ꯁꯨꯔꯛꯂꯕ
শুরগা	ꯁꯨꯔꯒ
শুরদুনা	ꯁꯨꯔꯗꯨꯅꯥ
শুরবা	ꯁꯨꯔꯕ
শুরবী	ꯁꯨꯔꯕꯤ
শুরি	ꯁꯨꯔꯤ
শুরিবা	ꯁꯨꯔꯤꯕ
শুরে	ꯁꯨꯔꯦ
শুহন্নবা	ꯁꯨꯍꯟꯅꯕ
শূ	ꯁꯨ
শূবা	ꯁꯨꯕꯥ
শেং	ꯁꯦꯡ
শেংই	ꯁꯦꯡꯏ
শেংদবগী	ꯁꯦꯡꯗꯕꯒꯤ
শেংদবা	ꯁꯦꯡꯗꯕ
শেংনবা	ꯁꯦꯪꯅꯕꯥ
শেংনা	ꯁꯦꯡꯅ
শেংবগা	ꯁꯦꯡꯕꯒ
শেংবগী	ꯁꯦꯡꯕꯒꯤ
শেংবা	ꯁꯦꯡꯕ
শেংলবা	ꯁꯦꯡꯂꯕ
শেংহল্লে	ꯁꯦꯡꯍꯜꯂꯦ
শেঞ্জা	ꯁꯦꯟꯖꯥ
শেত্তুনা	ꯁꯦꯠꯇꯨꯅꯥ
শেন	ꯁꯦꯟ
শেনখি	ꯁꯦꯟꯈꯤ
শেনগী	ꯁꯦꯟꯒꯤ
শেনফম	ꯁꯦꯟꯐꯝ
শেনফমনা	ꯁꯦꯟꯐꯝꯅ
শেনফমশিং	ꯁꯦꯟꯐꯝꯁꯤꯡ
শেনবগী	ꯁꯦꯅꯕꯒꯤ
শেনবা	ꯁꯦꯅꯕ
শেনবিনবা	ꯁꯦꯅꯕꯤꯅꯕ
শেন্থং	ꯁꯦꯟꯊꯪ
শেন্দান	ꯁꯦꯟꯗꯥꯟ
শেন্দুনা	ꯁꯦꯟꯗꯨꯅ
শেন্নদুনা	ꯁꯦꯟꯅꯗꯨꯅ
শেন্ননবা	ꯁꯦꯟꯅꯅꯕ
শেন্নবগী	ꯁꯦꯟꯅꯕꯒꯤ
শেন্নবা	ꯁꯦꯟꯅꯕ
শেন্নরি	ꯁꯦꯟꯅꯔꯤ
শেন্নরিবা	ꯁꯦꯟꯅꯔꯤꯕ
শেবা	ꯁꯦꯕꯥ
শেম	ꯁꯦꯝ
শেমখি	ꯁꯦꯝꯈꯤ
শেমখিদে	ꯁꯦꯝꯈꯤꯗꯦ
শেমখিবগা	ꯁꯦꯝꯈꯤꯕꯒ
শেমখিবগী	ꯁꯦꯝꯈꯤꯕꯒꯤ
শেমখিবনি	ꯁꯦꯝꯈꯤꯕꯅꯤ
শেমখিবা	ꯁꯦꯝꯈꯤꯕ
শেমখ্রে	ꯁꯦꯝꯈꯔꯦ
শেমগদবনি	ꯁꯦꯝꯒꯗꯕꯅꯤ
শেমগনি	ꯁꯦꯝꯒꯅꯤ
শেমগৎ	ꯁꯦꯃꯒꯠ
শেমগৎতুনা	ꯁꯦꯝꯒꯠꯇꯨꯅ
শেমগৎনবগী	ꯁꯦꯝꯒꯠꯅꯕꯒꯤ
শেমগৎনবা	ꯁꯦꯝꯒꯠꯅꯕ
শেমগৎপগী	ꯁꯦꯝꯒꯠꯄꯒꯤ
শেমগৎপদা	ꯁꯦꯝꯒꯠꯄꯗ
শেমগৎপনি	ꯁꯦꯝꯒꯠꯄꯅꯤ
শেমগৎপা	ꯁꯦꯝꯒꯠꯄ
শেমগৎলকপা	ꯁꯦꯝꯒꯠꯂꯛꯄ
শেমগৎলম্বা	ꯁꯦꯝꯒꯠꯂꯝꯕ
শেমগৎলম্মী	ꯁꯦꯝꯒꯠꯂꯝꯃꯤ
শেমগৎলি	ꯁꯦꯝꯒꯠꯂꯤ
শেমগৎলিবা	ꯁꯦꯝꯒꯠꯂꯤꯕ
শেমগৎলে	ꯁꯦꯝꯒꯠꯂꯦ
শেমজবা	ꯁꯦꯝꯖꯕ
শেমজিন	ꯁꯦꯝꯖꯤꯟ
শেমজিনবগী	ꯁꯦꯝꯖꯤꯟꯕꯒꯤ
শেমজিনবা	ꯁꯦꯝꯖꯤꯟꯕ
শেমজিন্নবা	ꯁꯦꯝꯖꯤꯟꯅꯕ
শেমদুনা	ꯁꯦꯝꯗꯨꯅ
শেম্নদুনা	ꯁꯦꯝꯅꯗꯨꯅ
শেম্ননবগীদমক	ꯁꯦꯝꯅꯅꯕꯒꯤꯗꯃꯛ
শেম্ননবা	ꯁꯦꯝꯅꯅꯕ
শেম্নবগী	ꯁꯦꯝꯅꯕꯒꯤ
শেম্নবগীদমক	ꯁꯦꯝꯅꯕꯒꯤꯗꯃꯛ
শেম্নবা	ꯁꯦꯝꯅꯕ
শেম্বগা	ꯁꯦꯝꯕꯒ
শেম্বগী	ꯁꯦꯝꯕꯒꯤ
শেম্বদা	ꯁꯦꯝꯕꯗ
শেম্বনি	ꯁꯦꯝꯕꯅꯤ
শেম্বা	ꯁꯦꯝꯕ
শেম্বীদবনা	ꯁꯦꯝꯕꯤꯗꯕꯅꯥ
শেম্বীনবা	ꯁꯦꯝꯕꯤꯅꯕ
শেম্বীবা	ꯁꯦꯝꯕꯤꯕ
শেম্বীয়ু	ꯁꯦꯝꯕꯤꯌꯨ
শেম্লকপনি	ꯁꯦꯝꯂꯛꯄꯅꯤ
শেম্লকপা	ꯁꯦꯝꯂꯛꯄ
শেম্লগনি	ꯁꯦꯝꯂꯒꯅꯤ
শেম্লগা	ꯁꯦꯝꯂꯒ
শেম্লবদি	ꯁꯦꯝꯂꯕꯗꯤ
শেম্লবা	ꯁꯦꯝꯂꯕ
শেম্লম্বা	ꯁꯦꯝꯂꯝꯕ
শেম্লি	ꯁꯦꯝꯂꯤ
শেম্লিবা	ꯁꯦꯝꯂꯤꯕ
শেম্লে	ꯁꯦꯝꯂꯦ
শেরান	ꯁꯦꯔꯥꯅ
শেল	ꯁꯦꯜ
শেলগী	ꯁꯦꯜꯒꯤ
শেলদগী	ꯁꯦꯜꯗꯒꯤ
শেল্লি	ꯁꯦꯜꯂꯤ
শেৎ	ꯁꯦꯠ
শেৎতুনা	ꯁꯦꯠꯇꯨꯅ
শেৎলি	ꯁꯦꯠꯂꯤ
শৈখ	ꯁꯩꯈ
শৈজাং	ꯁꯩꯖꯥꯡ
শৈথা	ꯁꯩꯊꯥ
শৈথাবা	ꯁꯩꯊꯥꯕ
শৈথারি	ꯁꯩꯊꯥꯔꯤ
শৈদিন্নবগী	ꯁꯩꯗꯤꯟꯅꯕꯒꯤ
শৈদিন্নবা	ꯁꯩꯗꯤꯟꯅꯕ
শৈপাল	ꯁꯩꯄꯥꯜ
শৈরেং	ꯁꯩꯔꯦꯡ
শৈরেংগী	ꯁꯩꯔꯦꯡꯒꯤ
শৈরেংবশিংগী	ꯁꯩꯔꯦꯡꯕꯁꯤꯡꯒꯤ
শৈরেংবা	ꯁꯩꯔꯦꯡꯕ
শৈরেংশিং	ꯁꯩꯔꯦꯡꯁꯤꯡ
শৈশকপা	ꯁꯩꯁꯛꯄꯥ
শৈশকপী	ꯁꯩꯁꯛꯄꯤ
শৈহেক	ꯁꯩꯍꯦꯛ
শ্বর	ꯁꯣꯔ
শ্রধাঞ্জলি	ꯁ꯭ꯔꯙꯥꯟꯖꯂꯤ
শ্রী	ꯁ꯭ꯔꯤ
শ্রীধর	ꯁ꯭ꯔꯤꯙꯔ
শ্রীনগর	ꯁ꯭ꯔꯤꯅꯒꯔ
শ্রীমতি	ꯁ꯭ꯔꯤꯃꯇꯤ
শ্রীরামগী	ꯁ꯭ꯔꯤꯔꯥꯝꯒꯤ
শ্রীলঙ্কা	ꯁ꯭ꯔꯤꯂꯡꯀꯥ
শ্রীলঙ্কাগা	ꯁ꯭ꯔꯤꯂꯡꯀꯥꯒ
শ্রীলঙ্কাগী	ꯁ꯭ꯔꯤꯂꯡꯀꯥꯒꯤ
শ্রীলঙ্কাদা	ꯁ꯭ꯔꯤꯂꯡꯀꯥꯗ
শ্রীলঙ্কানা	ꯁ꯭ꯔꯤꯂꯡꯀꯥꯅ
ষন	ꯁꯟ
ষ্টদি	ꯁ꯭ꯇꯗꯤ
ষ্টদিয়মদা	ꯁ꯭ꯇꯗꯤꯌꯝꯗ
ষ্টাইল	ꯁ꯭ꯇꯥꯏꯜ
ষ্টাইলদা	ꯁ꯭ꯇꯥꯏꯜꯗꯥ
ষ্টাফ	ꯁ꯭ꯇꯥꯐ
ষ্টাফকী	ꯁ꯭ꯇꯥꯐꯀꯤ
ষ্টাফতা	ꯁ꯭ꯇꯥꯐꯇ
ষ্টাফশিং	ꯁ꯭ꯇꯥꯐꯁꯤꯡ
ষ্টাফশিংগা	ꯁ꯭ꯇꯥꯐꯁꯤꯡꯒ
ষ্টাফশিংগী	ꯁ꯭ꯇꯥꯐꯁꯤꯡꯒꯤ
ষ্টাফশিংদা	ꯁ꯭ꯇꯥꯐꯁꯤꯡꯗ
ষ্টাফশিংনা	ꯁ꯭ꯇꯥꯐꯁꯤꯡꯅ
ষ্টাফশিংবু	ꯁ꯭ꯇꯥꯐꯁꯤꯡꯕꯨ
ষ্টাম্প	ꯁ꯭ꯇꯥꯝ
ষ্টার	ꯁ꯭ꯇꯥꯔ
ষ্টার্ট	ꯁ꯭ꯇꯥꯔꯠ
ষ্টিক	ꯁ꯭ꯇꯤꯛ
ষ্টিল	ꯁ꯭ꯇꯤꯜ
ষ্টিয়ারিং	ꯁ꯭ꯇꯤꯌꯥꯔꯤꯡ
ষ্টুদিও	ꯁ꯭ꯇꯨꯗꯤꯑꯣ
ষ্টুদিওদা	ꯁ꯭ꯇꯨꯗꯤꯑꯣꯗ
ষ্টুদেন্ট	ꯁ꯭ꯇꯨꯗꯦꯟꯇ
ষ্টুদেন্টস	ꯁ꯭ꯇꯨꯗꯦꯟꯇꯁ
ষ্টে	ꯁ꯭ꯇꯦ
ষ্টেগী	ꯁ꯭ꯇꯦꯒꯤ
ষ্টেজ	ꯁ꯭ꯇꯦꯖ
ষ্টেজগী	ꯁ꯭ꯇꯦꯖꯒꯤ
ষ্টেজতা	ꯁ꯭ꯇꯦꯖꯇ
ষ্টেজদা	ꯁ꯭ꯇꯦꯖꯗ
ষ্টেট	ꯁ꯭ꯇꯦꯠ
ষ্টেটকী	ꯁ꯭ꯇꯦꯠꯀꯤ
ষ্টেটনসু	ꯁ꯭ꯇꯦꯠꯅꯁꯨ
ষ্টেটনা	ꯁ꯭ꯇꯦꯠꯅ
ষ্টেটমেন্ট	ꯁ꯭ꯇꯦꯠꯃꯦꯟꯇ
ষ্টেটশিংগী	ꯁ꯭ꯇꯦꯠꯁꯤꯡꯒꯤ
ষ্টেটশিংদা	ꯁ꯭ꯇꯦꯠꯁꯤꯡꯗ
ষ্টেটশিংনা	ꯁ꯭ꯇꯦꯠꯁꯤꯡꯅ
ষ্টেটস	ꯁ꯭ꯇꯦꯇꯁ
ষ্টেটসকী	ꯁ꯭ꯇꯦꯇꯁꯀꯤ
ষ্টেটসতা	ꯁ꯭ꯇꯦꯇꯁꯇ
ষ্টেটহুদ	ꯁ꯭ꯇꯦꯠꯍꯨꯗ
ষ্টেটিষ্টিক্স	ꯁ꯭ꯇꯦꯇꯤꯁꯇꯤꯛꯁ
ষ্টেদিয়ম	ꯁ꯭ꯇꯦꯗꯤꯌꯝ
ষ্টেদিয়মদা	ꯁ꯭ꯇꯦꯗꯤꯌꯝꯗ
ষ্টেদিয়মশিং	ꯁ꯭ꯇꯦꯗꯤꯌꯝꯁꯤꯡ
ষ্টেনা	ꯁ꯭ꯇꯦꯅꯥ
ষ্টেন্দর্দ	ꯁ꯭ꯇꯦꯟꯗꯔꯗ
ষ্টেন্দার্দ	ꯁ꯭ꯇꯦꯟꯗꯥꯔꯗ
ষ্টেন্দিং	ꯁ꯭ꯇꯦꯟꯗꯤꯡ
ষ্টেপ	ꯁ꯭ꯇꯦꯞ
ষ্টেফেন	ꯁ꯭ꯇꯦꯐꯦꯡꯅ
ষ্টেবল	ꯁ꯭ꯇꯦꯕꯜ
ষ্টেলিন	ꯁ꯭ꯇꯦꯂꯤꯟ
ষ্টেসন	ꯁ꯭ꯇꯦꯁꯟ
ষ্টেসনগী	ꯁ꯭ꯇꯦꯁꯟꯒꯤ
ষ্টেসনদগী	ꯁ꯭ꯇꯦꯁꯟꯗꯒꯤ
ষ্টেসনদা	ꯁ꯭ꯇꯦꯁꯟꯗ
ষ্টেসনশিং	ꯁ꯭ꯇꯦꯁꯟꯁꯤꯡ
ষ্টেসনশিংগী	ꯁ꯭ꯇꯦꯁꯟꯁꯤꯡꯒꯤ
ষ্টেসনশিংদা	ꯁ꯭ꯇꯦꯁꯟꯁꯤꯡꯗ
ষ্ট্রকচর	ꯁ꯭ꯇꯔꯛꯆꯔ
ষ্ট্রগল	ꯁ꯭ꯇꯔꯒꯜ
ষ্ট্রাইক	ꯁ꯭ꯇꯔꯥꯏꯛ
ষ্ট্রাইকনা	ꯁ꯭ꯇꯔꯥꯏꯛꯅ
ষ্ট্রাইকর	ꯁ꯭ꯇꯔꯥꯏꯀꯔ
ষ্ট্রিট	ꯁ꯭ꯇꯔꯤꯠ
ষ্ট্রিম	ꯁ꯭ꯇꯔꯤꯝ
ষ্ট্রেট	ꯁ꯭ꯇꯔꯦꯠ
ষ্ট্রেটেজি	ꯁ꯭ꯇꯔꯦꯇꯦꯖꯤ
ষ্ট্রেসন	ꯁ꯭ꯇꯔꯦꯁꯟ
স	ꯁ
সংকল্প	ꯁꯪꯀꯜꯄ
সংবিধান	ꯁꯪꯕꯤꯙꯥꯟ
সংবিধাননা	ꯁꯪꯕꯤꯙꯥꯟꯅ
সংবিধানবু	ꯁꯪꯕꯤꯙꯥꯟꯕꯨ
সংমা	ꯁꯪꯃꯥ
সংমানা	ꯁꯪꯃꯥꯅ
সংসার	ꯁꯪꯁꯥꯔ
সংসারদা	ꯁꯪꯁꯥꯔꯗ
সংস্কৃতি	ꯁꯪꯁꯀ꯭ꯔꯇꯤ
সংস্কৃতিগী	ꯁꯪꯁꯀ꯭ꯔꯇꯤꯒꯤ
সংস্কৃতিদা	ꯁꯪꯁꯀ꯭ꯔꯇꯤꯗ
সংস্কৃতিবু	ꯁꯪꯁꯀ꯭ꯔꯇꯤꯕꯨ
সংস্থান	ꯁꯪꯁꯊꯥꯟ
সংস্থানশিং	ꯁꯪꯁꯊꯥꯟꯁꯤꯡ
সংস্থানশিংগা	ꯁꯪꯁꯊꯥꯟꯁꯤꯡꯒ
সংস্থানশিংগী	ꯁꯪꯁꯊꯥꯟꯁꯤꯡꯒꯤ
সংস্থানশিংনা	ꯁꯪꯁꯊꯥꯟꯁꯤꯡꯅ
সংহাই	ꯁꯪꯍꯥꯏ
সঙাই	ꯁꯉꯥꯏ
সঙাইবু	ꯁꯉꯥꯏꯕꯨ
সঙ্গিত	ꯁꯡꯒꯤꯠ
সঙ্গিৎ	ꯁꯡꯒꯤꯠ
সঙ্গীত	ꯁꯡꯒꯤꯠ
সঙ্ঘ	ꯁꯡꯘ
সঙ্ঘথন	ꯁꯡꯘꯊꯟ
সচিন	ꯁꯆꯤꯟ
সজেসন	ꯁꯖꯦꯁꯟ
সজেসনশিং	ꯁꯖꯦꯁꯟꯁꯤꯡ
সঞ্জিব	ꯁꯟꯖꯤꯕ
সঞ্জু	ꯁꯟꯖꯨ
সঞ্জেনবম	ꯁꯟꯖꯦꯅꯕꯝ
সঞ্জেনবমদা	ꯁꯟꯖꯦꯟꯕꯝꯗ
সঞ্জয়	ꯁꯟꯖꯌ
সতৱিক	ꯁꯠꯋꯤꯛ
সদ	ꯁꯗ
সদর	ꯁꯗꯔ
সদানন্দা	ꯁꯗꯥꯅꯟꯗꯥ
সদার	ꯁꯗꯥꯔ
সধারন	ꯁꯙꯥꯔꯟ
সন	ꯁꯟ
সনজিৎ	ꯁꯟꯖꯤꯠ
সনসম	ꯁꯟꯁꯝ
সনা	ꯁꯅꯥ
সনাগী	ꯁꯅꯥꯒꯤ
সনাজাওবনা	ꯁꯅꯥꯖꯥꯑꯣꯕꯅ
সনাজাওববু	ꯁꯅꯥꯖꯥꯑꯣꯕꯕꯨ
সনাজাওবা	ꯁꯅꯥꯖꯥꯑꯣꯕꯥ
সনানা	ꯁꯅꯥꯅ
সনাবী	ꯁꯅꯥꯕꯤ
সনামচা	ꯁꯅꯥꯃꯆꯥ
সনামচানা	ꯁꯅꯥꯃꯆꯥꯅ
সনামহি	ꯁꯅꯥꯃꯍꯤ
সনামহীনা	ꯁꯅꯥꯃꯍꯤꯅꯥ
সনাহনবী	ꯁꯅꯥꯍꯟꯕꯤ
সনাহল	ꯁꯅꯥꯍꯜ
সন্দে	ꯁꯟꯗꯦ
সপ্লাই	ꯁꯄ꯭ꯂꯥꯏ
সপ্লাইগী	ꯁꯄ꯭ꯂꯥꯏꯒꯤ
সপ্লাইদা	ꯁꯄ꯭ꯂꯥꯏꯗ
সপ্লাইনা	ꯁꯄ꯭ꯂꯥꯏꯅ
সব	ꯁꯕ
সবকা	ꯁꯕꯀꯥ
সবজেক্ট	ꯁꯕꯖꯦꯛꯇ
সবজেক্টশিং	ꯁꯕꯖꯦꯛꯇꯁꯤꯡ
সবসটেন্স	ꯁꯕꯁꯇꯦꯟꯁ
সবসিদি	ꯁꯕꯁꯤꯗꯤ
সবা	ꯁꯕꯥ
সবিতা	ꯁꯕꯤꯇꯥ
সভা	ꯁꯚꯥ
সভাগী	ꯁꯚꯥꯒꯤ
সভাদা	ꯁꯚꯥꯗ
সম	ꯁꯝ
সমরপন	ꯁꯝꯔꯞꯅ
সমাজ	ꯁꯃꯥꯖ
সমাজগী	ꯁꯃꯥꯖꯒꯤ
সমাজদা	ꯁꯃꯥꯖꯗ
সমাজিক	ꯁꯃꯥꯖꯤꯛ
সমাজৱাদি	ꯁꯃꯥꯖꯋꯥꯗꯤ
সমাধি	ꯁꯃꯥꯙꯤ
সমিট	ꯁꯃꯤꯠ
সমিটতা	ꯁꯃꯤꯠꯇꯥ
সমিতি	ꯁꯃꯤꯇꯤ
সমুদ্র	ꯁꯃꯨꯗ꯭ꯔ
সমুদ্রগী	ꯁꯃꯨꯗ꯭ꯔꯒꯤ
সমুদ্রদা	ꯁꯃꯨꯗ꯭ꯔꯗ
সমুদ্রা	ꯁꯃꯨꯗꯔꯥ
সম্মর	ꯁꯝꯃꯔ
সম্মান	ꯁꯝꯃꯥꯅ
সম্মিটি	ꯁꯝꯃꯤꯇꯤ
সম্মেলন	ꯁꯝꯃꯦꯂꯟ
সরকার	ꯁꯔꯀꯥꯔ
সরকারগা	ꯁꯔꯀꯥꯔꯒ
সরকারগী	ꯁꯔꯀꯥꯔꯒꯤ
সরকারদা	ꯁꯔꯀꯥꯔꯗ
সরকারনদি	ꯁꯔꯀꯥꯔꯅꯗꯤ
সরকারনা	ꯁꯔꯀꯥꯔꯅ
সরকারবু	ꯁꯔꯀꯥꯔꯕꯨ
সরকারসু	ꯁꯔꯀꯥꯔꯁꯨ
সরত	ꯁꯔꯠ
সরতচন্দ্রনা	ꯁꯔꯠꯆꯟꯗ꯭ꯔꯅ
সরদা	ꯁꯔꯗꯥ
সরদার	ꯁꯔꯗꯥꯔ
সরস্বতি	ꯁꯔꯁ꯭ꯋꯇꯤ
সরাংথেম	ꯁꯔꯥꯡꯊꯦꯝ
সরেন্দর	ꯁꯔꯦꯟꯗꯔ
সরৈ	ꯁꯔꯩ
সর্চ	ꯁꯔꯆ
সর্ভিলেন্স	ꯁꯔꯚꯤꯂꯦꯟꯁ
সর্ভিলেন্সকী	ꯁꯔꯚꯤꯂꯦꯟꯁꯀꯤ
সর্ভিলেন্সতা	ꯁꯔꯚꯤꯂꯦꯟꯁꯇ
সর্ভিসেস	ꯁꯔꯚꯤꯁꯦꯁ
সর্ভে	ꯁꯔꯚꯦ
সলাই	ꯁꯂꯥꯏ
সলাম	ꯁꯂꯥꯝ
সলামনা	ꯁꯂꯥꯝꯅ
সলামি	ꯁꯂꯥꯃꯤ
সসিকুমারনা	ꯁꯁꯤꯀꯨꯃꯥꯔꯅ
সস্পেন্দ	ꯁꯁꯄꯦꯟꯗ
সস্পেন্সন	ꯁꯁꯄꯦꯟꯁꯟ
সহর	ꯁꯍꯔ
সহরগী	ꯁꯍꯔꯒꯤ
সহরদগী	ꯁꯍꯔꯗꯒꯤ
সহরদসু	ꯁꯍꯔꯗꯁꯨ
সহরদা	ꯁꯍꯔꯗ
সহি	ꯁꯍꯤ
সহিদ	ꯁꯍꯤꯗ
সাই	ꯁꯥꯏ
সাইকল	ꯁꯥꯏꯀꯜ
সাইকুল	ꯁꯥꯏꯀꯨꯜ
সাইক্লিং	ꯁꯥꯏꯛꯂꯤꯡ
সাইজ	ꯁꯥꯏꯖ
সাইট	ꯁꯥꯏꯠ
সাইটকী	ꯁꯥꯏꯠꯀꯤ
সাইটতা	ꯁꯥꯏꯠꯇꯥ
সাইটেসন	ꯁꯥꯏꯇꯦꯁꯟ
সাইতু	ꯁꯥꯏꯇꯨ
সাইতুগী	ꯁꯥꯏꯇꯨꯒꯤ
সাইদ	ꯁꯥꯏꯗ
সাইন	ꯁꯥꯏꯟ
সাইনা	ꯁꯥꯏꯅ
সাইনিক	ꯁꯥꯏꯅꯤꯛ
সাইন্টিফিক	ꯁꯥꯏꯟꯇꯤꯐꯤꯀ
সাইন্টিষ্ট	ꯁꯥꯏꯟꯇꯤꯁꯠ
সাইন্টিষ্টশিংনা	ꯁꯥꯏꯟꯇꯤꯁꯠꯁꯤꯡꯅ
সাইন্স	ꯁꯥꯏꯟꯁ
সাইন্সকী	ꯁꯥꯏꯟꯁꯀꯤ
সাইন্সতা	ꯁꯥꯏꯟꯁꯇ
সাইন্সনা	ꯁꯥꯏꯟꯁꯅ
সাইন্সেস	ꯁꯥꯏꯟꯁꯦꯁ
সাইবর	ꯁꯥꯏꯕꯔ
সাইরাজ	ꯁꯥꯏꯔꯥꯖ
সাইরেম	ꯁꯥꯏꯔꯦꯝ
সাথ	ꯁꯥꯊ
সান	ꯁꯥꯅ
সানা	ꯁꯥꯅꯥ
সান্তা	ꯁꯥꯟꯇꯥ
সাপম	ꯁꯥꯄꯝ
সাপমনা	ꯁꯥꯄꯝꯅ
সাম	ꯁꯥꯝ
সার্কল	ꯁꯥꯔꯀꯜ
সার্কলগী	ꯁꯥꯔꯀꯜꯒꯤ
সার্কলনা	ꯁꯥꯔꯀꯜꯅ
সার্ট	ꯁꯥꯔꯇ
সার্টিফিকেট	ꯁꯥꯔꯇꯤꯐꯤꯀꯦꯠ
সার্টিফিকেটসু	ꯁꯥꯔꯇꯤꯐꯤꯀꯦꯠꯁꯨ
সার্বিস	ꯁꯥꯔꯕꯤꯁ
সার্বিসকা	ꯁꯥꯔꯕꯤꯁꯀꯥ
সার্ভিস	ꯁꯥꯔꯚꯤꯁ
সার্ভিসকী	ꯁꯥꯔꯚꯤꯁꯀꯤ
সার্ভিসশিং	ꯁꯥꯔꯚꯤꯁꯁꯤꯡ
সার্ভিসসু	ꯁꯥꯔꯚꯤꯁꯁꯨ
সার্ভিসেস	ꯁꯥꯔꯚꯤꯁꯦꯁ
সার্ভিসেসকী	ꯁꯥꯔꯚꯤꯁꯦꯁꯀꯤ
সার্স	ꯁꯥꯔꯁ
সাসন	ꯁꯥꯁꯟ
সাসনগী	ꯁꯥꯁꯟꯒꯤ
সাহ	ꯁꯥꯍ
সাহেব	ꯁꯥꯍꯦꯕ
সাহেবনা	ꯁꯥꯍꯦꯕꯅ
সি	ꯁꯤ
সিং	ꯁꯤꯡ
সিংগল	ꯁꯤꯡꯒꯜ
সিংহ	ꯁꯤꯡꯍ
সিংহগা	ꯁꯤꯡꯍꯒ
সিংহগী	ꯁꯤꯡꯍꯒꯤ
সিংহদা	ꯁꯤꯡꯍꯗ
সিংহনা	ꯁꯤꯡꯍꯅ
সিংহনি	ꯁꯤꯡꯍꯅꯤ
সিংহবু	ꯁꯤꯡꯍꯕꯨ
সিংহসু	ꯁꯤꯡꯍꯁꯨ
সিএম	ꯁꯤꯑꯦꯝ
সিএমও	ꯁꯤꯑꯦꯝꯑꯣ
সিএমদা	ꯁꯤꯑꯦꯃꯗꯥ
সিক্কিম	ꯁꯤꯛꯀꯤꯝ
সিক্কিমদা	ꯁꯤꯛꯀꯤꯝꯗ
সিক্কিমদি	ꯁꯤꯛꯀꯤꯝꯗꯤ
সিক্স	ꯁꯤꯀꯁ
সিক্সতগী	ꯁꯤꯛꯁꯠꯒꯤ
সিক্সতগীনা	ꯁꯤꯛꯁꯠꯒꯤꯅꯥ
সিগী	ꯁꯤꯒꯤ
সিঙ্গর	ꯁꯤꯡꯒꯔ
সিঙ্গল	ꯁꯤꯡꯒꯜ
সিঙ্গা	ꯁꯤꯡꯒꯥ
সিচুয়েসন	ꯁꯤꯆꯨꯌꯦꯁꯟ
সিজ	ꯁꯤꯖ
সিজন	ꯁꯤꯖꯟ
সিজর	ꯁꯤꯖꯔ
সিট	ꯁꯤꯠ
সিটকী	ꯁꯤꯠꯀꯤ
সিটতা	ꯁꯤꯠꯇꯥ
সিটশিং	ꯁꯤꯠꯁꯤꯡ
সিটি	ꯁꯤꯇꯤ
সিটিগী	ꯁꯤꯇꯤꯒꯤ
সিটিজন	ꯁꯤꯇꯤꯖꯟ
সিটিদগী	ꯁꯤꯇꯤꯗꯒꯤ
সিটিদা	ꯁꯤꯇꯤꯗ
সিট্টিং	ꯁꯤꯠꯇꯤꯡ
সিতা	ꯁꯤꯇꯥ
সিতারমন	ꯁꯤꯇꯥꯔꯝꯅ
সিতারমননা	ꯁꯤꯇꯥꯔꯃꯟꯅ
সিতারাম	ꯁꯤꯇꯥꯔꯥꯝ
সিদগী	ꯁꯤꯗꯒꯤ
সিদা	ꯁꯤꯗꯥ
সিদি	ꯁꯤꯗꯤ
সিধু	ꯁꯤꯙꯨ
সিধুগী	ꯁꯤꯙꯨꯒꯤ
সিধুনা	ꯁꯤꯙꯨꯅ
সিন	ꯁꯤꯟ
সিনা	ꯁꯤꯅꯥ
সিনাম	ꯁꯤꯅꯥꯝ
সিনি	ꯁꯤꯅꯤ
সিনেমা	ꯁꯤꯅꯦꯃꯥ
সিনেমাগী	ꯁꯤꯅꯦꯃꯥꯒꯤ
সিনেমাদা	ꯁꯤꯅꯦꯃꯥꯗꯥ
সিনেমাশিং	ꯁꯤꯅꯦꯃꯥꯁꯤꯡ
সিন্দ	ꯁꯤꯟꯗ
সিপ	ꯁꯤꯞ
সিফাই	ꯁꯤꯐꯥꯏ
সিফাইশিংগা	ꯁꯤꯐꯥꯏꯁꯤꯡꯒ
সিব	ꯁꯤꯕ
সিবরাজ	ꯁꯤꯕꯔꯥꯖ
সিবিল	ꯁꯤꯕꯤꯜ
সিবু	ꯁꯤꯕꯨ
সিভিল	ꯁꯤꯚꯤꯜ
সিভিলিয়ান	ꯁꯤꯚꯤꯂꯤꯌꯥꯟ
সিমতে	ꯁꯤꯝꯇꯦ
সিমা	ꯁꯤꯃꯥ
সিরুই	ꯁꯤꯔꯨꯏ
সিল	ꯁꯤꯜ
সিলচর	ꯁꯤꯜꯆꯔ
সিলচরদগী	ꯁꯤꯜꯆꯔꯗꯒꯤ
সিলচরদা	ꯁꯤꯜꯆꯔꯗ
সিলভর	ꯁꯤꯜꯚꯔ
সিলভিয়ানা	ꯁꯤꯜꯚꯤꯌꯥꯅ
সিলা	ꯁꯤꯂꯥ
সিলিন্দর	ꯁꯤꯂꯤꯟꯗꯔ
সিলিন্দরশিং	ꯁꯤꯂꯤꯟꯗꯔꯁꯤꯡ
সিল্ড	ꯁꯤꯜꯗ
সিষ্টেম	ꯁꯤꯁ꯭ꯇꯦꯝ
সিষ্টেমগা	ꯁꯤꯁ꯭ꯇꯦꯝꯒ
সিষ্টেমগী	ꯁꯤꯁ꯭ꯇꯦꯝꯒꯤ
সিষ্টেমদা	ꯁꯤꯁ꯭ꯇꯦꯝꯗ
সিষ্টেমনা	ꯁꯤꯁ꯭ꯇꯦꯝꯅ
সিষ্টেমশিং	ꯁꯤꯁ꯭ꯇꯦꯝꯁꯤꯡ
সিসু	ꯁꯤꯁꯨ
সিয়া	ꯁꯤꯌꯥ
সিয়ার	ꯁꯤꯌꯥꯔ
সু	ꯁꯨ
সুইদেনগী	ꯁꯨꯏꯗꯦꯟꯒꯤ
সুইসাইদ	ꯁꯨꯏꯁꯥꯏꯗ
সুগর	ꯁꯨꯒꯔ
সুট	ꯁꯨꯠ
সুটিং	ꯁꯨꯇꯤꯡ
সুদ	ꯁꯨꯗ
সুধাকরনা	ꯁꯨꯙꯥꯀꯔꯅ
সুধির	ꯁꯨꯙꯤꯔ
সুনা	ꯁꯨꯅꯥ
সুনিল	ꯁꯨꯅꯤꯜ
সুন্দর	ꯁꯨꯟꯗꯔ
সুপর	ꯁꯨꯄꯔ
সুপরভাইজর	ꯁꯨꯄꯔꯚꯥꯏꯖꯔ
সুপরিনটেন্দেন্ট	ꯁꯨꯄꯔꯤꯟꯇꯦꯟꯗꯦꯟꯇ
সুপরিন্টেন্দেন্ট	ꯁꯨꯄꯔꯤꯟꯇꯦꯟꯗꯦꯟꯇ
সুপ্রিম	ꯁꯨꯄꯔꯤꯝ
সুবাসনা	ꯁꯨꯕꯥꯁꯅꯥ
সুবেদার	ꯁꯨꯕꯦꯗꯥꯔ
সুভাস	ꯁꯨꯚꯥꯁ
সুম	ꯁꯨꯃ
সুর	ꯁꯨꯔ
সুরচন্দ্রনা	ꯁꯨꯔꯆꯟꯗ꯭ꯔꯅ
সুরচন্দ্রবু	ꯁꯨꯔꯆꯟꯗ꯭ꯔꯕꯨ
সুরজ	ꯁꯨꯔꯖ
সুরজকান্তা	ꯁꯨꯔꯖꯀꯥꯟꯇ
সুরজনা	ꯁꯨꯔꯖꯅꯥ
সুরিয়া	ꯁꯨꯔꯤꯌꯥ
সুরেন্দ্রনা	ꯁꯨꯔꯦꯟꯗ꯭ꯔꯅ
সুরেস	ꯁꯨꯔꯦꯁ
সুরেসনা	ꯁꯨꯔꯦꯁꯅ
সুসাইদ	ꯁꯨꯁꯥꯏꯗ
সুসিল	ꯁꯨꯁꯤꯜ
সে	ꯁꯦ
সেকমাই	ꯁꯦꯛꯃꯥꯏ
সেকমাইগী	ꯁꯦꯀꯃꯥꯏꯒꯤ
সেকমাইনা	ꯁꯦꯀꯃꯥꯏꯅꯥ
সেকেন্দ	ꯁꯦꯀꯦꯟꯗ
সেকেন্দরি	ꯁꯦꯀꯦꯟꯗꯔꯤ
সেকেন্দরিগী	ꯁꯦꯀꯦꯟꯗꯔꯤꯒꯤ
সেকেন্দরিদা	ꯁꯦꯀꯦꯟꯗꯔꯤꯗ
সেক্যুরিটি	ꯁꯦꯀꯌ꯭ꯨꯔꯤꯇꯤ
সেক্যুরিটিগী	ꯁꯦꯀꯌ꯭ꯨꯔꯤꯇꯤꯒꯤ
সেক্যুলর	ꯁꯦꯀ꯭ꯌꯨꯂꯔ
সেক্স	ꯁꯦꯀ꯭ꯁ
সেক্সন	ꯁꯦꯛꯁꯟ
সেক্সনগী	ꯁꯦꯛꯁꯟꯒꯤ
সেক্সনদা	ꯁꯦꯛꯁꯟꯗ
সেক্সনশিং	ꯁꯦꯛꯁꯟꯁꯤꯡ
সেখর	ꯁꯦꯈꯔ
সেগমেন্ট	ꯁꯦꯒꯃꯦꯟꯇ
সেগমেন্টশিংদা	ꯁꯦꯒꯃꯦꯟꯇꯁꯤꯡꯗ
সেগা	ꯁꯦꯒꯥ
সেঙ্ক	ꯁꯦꯡꯀ
সেঙ্কচুঅরি	ꯁꯦꯡꯀꯆꯨꯑꯔꯤ
সেঙ্কচুঅরিশিং	ꯁꯦꯡꯀꯆꯨꯑꯔꯤꯁꯤꯡ
সেঙ্কসন	ꯁꯦꯡꯀꯁꯟ
সেঞ্চুরি	ꯁꯦꯟꯆꯨꯔꯤ
সেঞ্জেংগী	ꯁꯦꯟꯖꯦꯡꯒꯤ
সেট	ꯁꯦꯠ
সেটতা	ꯁꯦꯠꯇꯥ
সেটশিং	ꯁꯦꯠꯁꯤꯡ
সেটিলাইট	ꯁꯦꯇꯤꯂꯥꯏꯠ
সেট্টলমেন্ট	ꯁꯦꯠꯇꯂꯃꯦꯟꯇ
সেতু	ꯁꯦꯇꯨ
সেনা	ꯁꯦꯅꯥ
সেনাগী	ꯁꯦꯅꯥꯒꯤ
সেনানা	ꯁꯦꯅꯥꯅ
সেনাপটি	ꯁꯦꯅꯥꯄꯇꯤ
সেনাপতি	ꯁꯦꯅꯥꯄꯇꯤ
সেনাপতিগী	ꯁꯦꯅꯥꯄꯇꯤꯒꯤ
সেনাপতিদগী	ꯁꯦꯅꯥꯄꯇꯤꯗꯒꯤ
সেনাপতিদা	ꯁꯦꯅꯥꯄꯇꯤꯗ
সেনিটরি	ꯁꯦꯅꯤꯇꯔꯤ
সেনিটাইজ	ꯁꯦꯅꯤꯇꯥꯏꯖ
সেনিটাইজর	ꯁꯦꯅꯤꯇꯥꯏꯖꯔ
সেনিটাইজরনা	ꯁꯦꯅꯤꯇꯥꯏꯖꯔꯅ
সেনিটাইজরশিং	ꯁꯦꯅꯤꯇꯥꯏꯖꯔꯁꯤꯡ
সেনিটাইজেসন	ꯁꯦꯅꯤꯇꯥꯏꯖꯦꯁꯟ
সেনিটাইজেসনগী	ꯁꯦꯅꯤꯇꯥꯏꯖꯦꯁꯟꯒꯤ
সেনিটেসন	ꯁꯦꯅꯤꯇꯦꯁꯟ
সেনিয়র	ꯁꯦꯅꯤꯌꯔ
সেনিয়ার	ꯁꯦꯅꯤꯌꯥꯔ
সেন্ট	ꯁꯦꯟꯇ
সেন্টর	ꯁꯦꯟꯇꯔ
সেন্টরগী	ꯁꯦꯟꯇꯔꯒꯤ
সেন্টরদগী	ꯁꯦꯟꯇꯔꯗꯒꯤ
সেন্টরদসু	ꯁꯦꯟꯇꯔꯗꯁꯨ
সেন্টরদা	ꯁꯦꯟꯇꯔꯗ
সেন্টরনা	ꯁꯦꯟꯇꯔꯅ
সেন্টরশিং	ꯁꯦꯟꯇꯔꯁꯤꯡ
সেন্টরশিংগী	ꯁꯦꯟꯇꯔꯁꯤꯡꯒꯤ
সেন্টরশিংদা	ꯁꯦꯟꯇꯔꯁꯤꯡꯗ
সেন্টরশিংনা	ꯁꯦꯟꯇꯔꯁꯤꯡꯅ
সেন্সস	ꯁꯦꯟꯁꯁ
সেন্সসকী	ꯁꯦꯟꯁꯁꯀꯤ
সেপ্তেম্বর	ꯁꯦꯞꯇꯦꯝꯕꯔ
সেপ্তেম্বরদা	ꯁꯦꯞꯇꯦꯝꯕꯔꯗ
সেফ	ꯁꯦꯐ
সেব	ꯁꯦꯕ
সেবা	ꯁꯦꯕꯥ
সেবাগী	ꯁꯦꯕꯥꯒꯤ
সেবাদা	ꯁꯦꯕꯥꯗ
সেভ	ꯁꯦꯚ
সেভা	ꯁꯦꯚꯥ
সেমি	ꯁꯦꯃꯤ
সেমিনার	ꯁꯦꯃꯤꯅꯥꯔ
সেমিনারদা	ꯁꯦꯃꯤꯅꯥꯔꯗ
সেমিফাইনেল	ꯁꯦꯃꯤꯐꯥꯏꯅꯦꯜ
সেম্পল	ꯁꯦꯝꯄꯜ
সেম্পলশিং	ꯁꯦꯝꯄꯜꯁꯤꯡ
সের	ꯁꯦꯔ
সেরম	ꯁꯦꯔꯝ
সেরাম	ꯁꯦꯔꯥꯝ
সেরিং	ꯁꯦꯔꯤꯡ
সেরিকলচর	ꯁꯦꯔꯤꯀꯜꯆꯔ
সেরিজ	ꯁꯦꯔꯤꯖ
সেরিজকী	ꯁꯦꯔꯤꯖꯀꯤ
সেরিয়েল	ꯁꯦꯔꯤꯌꯦꯜ
সেল	ꯁꯦꯜ
সেলগী	ꯁꯦꯜꯒꯤ
সেলনা	ꯁꯦꯜꯅ
সেলুট	ꯁꯦꯂꯨꯠ
সেলেক্সন	ꯁꯦꯂꯦꯛꯁꯟ
সেলেবসতা	ꯁꯦꯂꯦꯕꯁꯇ
সেল্ফ	ꯁꯦꯜꯐ
সেস	ꯁꯦꯁ
সেসন	ꯁꯦꯁꯟ
সেসনগী	ꯁꯦꯁꯟꯒꯤ
সেসনদা	ꯁꯦꯁꯟꯗ
সেসন্স	ꯁꯦꯁꯟꯁ
স্কামদা	ꯁ꯭ꯀꯥꯝꯗ
স্কার	ꯁ꯭ꯀꯥꯔ
স্কিম	ꯁ꯭ꯀꯤꯝ
স্কিমগী	ꯁ꯭ꯀꯤꯝꯒꯤ
স্কিমদা	ꯁ꯭ꯀꯤꯝꯗ
স্কিমশিং	ꯁ꯭ꯀꯤꯝꯁꯤꯡ
স্কিমশিংগী	ꯁ꯭ꯀꯤꯝꯁꯤꯡꯒꯤ
স্কিমশিংনা	ꯁ꯭ꯀꯤꯝꯁꯤꯡꯅ
স্কিল	ꯁ꯭ꯀꯤꯜ
স্কুটর	ꯁ꯭ꯀꯨꯇꯔ
স্কুল	ꯁ꯭ꯀꯨꯜ
স্কুলগী	ꯁ꯭ꯀꯨꯜꯒꯤ
স্কুলদগী	ꯁ꯭ꯀꯨꯜꯗꯒꯤ
স্কুলদা	ꯁ꯭ꯀꯨꯜꯗ
স্কুলনা	ꯁ꯭ꯀꯨꯜꯅꯥ
স্কুলবু	ꯁ꯭ꯀꯨꯜꯕꯨ
স্কুলশিং	ꯁ꯭ꯀꯨꯜꯁꯤꯡ
স্কুলশিংগী	ꯁ꯭ꯀꯨꯜꯁꯤꯡꯒꯤ
স্কুলশিংদনা	ꯁ꯭ꯀꯨꯜꯁꯤꯡꯗꯅ
স্কুলশিংদসু	ꯁ꯭ꯀꯨꯜꯁꯤꯡꯗꯁꯨ
স্কুলশিংদা	ꯁ꯭ꯀꯨꯜꯁꯤꯡꯗ
স্কুলশিংনা	ꯁ꯭ꯀꯨꯜꯁꯤꯡꯅ
স্কুলশিংসু	ꯁ꯭ꯀꯨꯜꯁꯤꯡꯁꯨ
স্কুলস	ꯁ꯭ꯀꯨꯜꯁ
স্কেন্নিং	ꯁ꯭ꯀꯦꯟꯅꯤꯡ
স্কেল	ꯁ꯭ꯀꯦꯜ
স্ক্রিন	ꯁ꯭ꯀꯔꯤꯟ
স্ক্রিনিং	ꯁ꯭ꯀꯔꯤꯅꯤꯡ
স্পা	ꯁ꯭ꯄꯥ
স্পাইস	ꯁ꯭ꯄꯥꯏꯁ
স্পাস	ꯁꯄꯥꯁ
স্পিকর	ꯁ꯭ꯄꯤꯀꯔ
স্পিচ	ꯁ꯭ꯄꯤꯆ
স্পিদ	ꯁ꯭ꯄꯤꯗ
স্পিরিচুয়েল	ꯁ꯭ꯄꯤꯔꯤꯆꯨꯌꯦꯜ
স্পিসিয়েল	ꯁ꯭ꯄꯤꯁꯤꯌꯦꯜ
স্পিসিয়েলিষ্ট	ꯁ꯭ꯄꯤꯁꯤꯌꯦꯂꯤꯁꯠ
স্পিসিয়েলিষ্টশিং	ꯁ꯭ꯄꯤꯁꯤꯌꯦꯂꯤꯁꯠꯁꯤꯡ
স্পিসিয়েল্লি	ꯁ꯭ꯄꯤꯁꯤꯌꯦꯜꯂꯤ
স্পেনদা	ꯁ꯭ꯄꯦꯟꯗ
স্পেননা	ꯁ꯭ꯄꯦꯟꯅ
স্পেনিস	ꯁꯄꯦꯅꯤꯁ
স্পেস	ꯁ꯭ꯄꯦꯁ
স্পেসতা	ꯁ꯭ꯄꯦꯁꯇꯥ
স্পেসিয়েল	ꯁ꯭ꯄꯦꯁꯤꯌꯦꯜ
স্প্রিং	ꯁ꯭ꯄꯔꯤꯡ
স্বর	ꯁ꯭ꯋꯔ
স্বাব	ꯁ꯭ꯋꯥꯕ
স্বামি	ꯁ꯭ꯋꯥꯃꯤ
স্বামী	ꯁ꯭ꯋꯥꯃꯤ
স্বিজ	ꯁꯕꯤꯖ
স্বিপ	ꯁꯕꯤꯞ
স্বিমিং	ꯁꯕꯤꯃꯤꯡ
স্বিস	ꯁꯕꯤꯁ
স্মগ্লিং	ꯁꯃꯒꯂꯤꯡ
স্মার্ট	ꯁꯃꯥꯔꯠ
হ	ꯍ
হং	ꯍꯪ
হংই	ꯍꯪꯏ
হংখি	ꯍꯪꯈꯤ
হংখিবা	ꯍꯪꯈꯤꯕ
হংগে	ꯍꯪꯒꯦ
হংচিৎনা	ꯍꯪꯆꯤꯠꯅ
হংদুনা	ꯍꯪꯗꯨꯅ
হংবগী	ꯍꯪꯕꯒꯤ
হংবদা	ꯍꯪꯕꯗ
হংবা	ꯍꯪꯕ
হংলকখি	ꯍꯪꯂꯛꯈꯤ
হংলকপা	ꯍꯪꯂꯛꯄ
হংলগা	ꯍꯪꯂꯒꯥ
হংলি	ꯍꯪꯂꯤ
হংলুবদা	ꯍꯪꯂꯨꯕꯗꯥ
হক	ꯍꯛ
হকচাং	ꯍꯛꯆꯥꯡ
হকচাংগী	ꯍꯛꯆꯥꯡꯒꯤ
হকচাংদা	ꯍꯛꯆꯥꯡꯗ
হকচাংদি	ꯍꯛꯆꯥꯡꯗꯤ
হকচাংবু	ꯍꯛꯆꯥꯡꯕꯨ
হকচাংশিং	ꯍꯛꯆꯥꯡꯁꯤꯡ
হকচাংসু	ꯍꯛꯆꯥꯡꯁꯨ
হকচিনবা	ꯍꯛꯆꯤꯟꯕ
হকচিন্না	ꯍꯛꯆꯤꯟꯅ
হকথেংননা	ꯍꯛꯊꯦꯡꯅꯅꯥ
হকনি	ꯍꯛꯅꯤ
হকপু	ꯍꯛꯄꯨ
হকশিং	ꯍꯛꯁꯤꯡ
হকশেল	ꯍꯛꯁꯦꯜ
হকশেলগা	ꯍꯛꯁꯦꯜꯒꯥ
হকশেলগী	ꯍꯛꯁꯦꯜꯒꯤ
হকশেলদা	ꯍꯛꯁꯦꯜꯗ
হক্কীদমক	ꯍꯛꯀꯤꯗꯃꯛ
হঙ্গাম	ꯍꯡꯒꯥꯝꯒ
হঙ্গেরি	ꯍꯡꯒꯦꯔꯤ
হঙ্গৎ	ꯍꯡꯒꯠ
হঙ্গৎনা	ꯍꯡꯒꯠꯅ
হজবেন্দরি	ꯍꯖꯕꯦꯟꯗꯔꯤ
হঞ্জিন	ꯍꯟꯖꯤꯟ
হঞ্জিনবা	ꯍꯟꯖꯤꯟꯕ
হঞ্জিন্নবা	ꯍꯟꯖꯤꯟꯅꯕ
হঞ্জিন্না	ꯍꯟꯖꯤꯟꯅ
হঞ্জিল্লকপদা	ꯍꯟꯖꯤꯜꯂꯛꯄꯗ
হঞ্জিল্লকপা	ꯍꯟꯖꯤꯜꯂꯛꯄ
হঞ্জিল্লক্কনি	ꯍꯟꯖꯤꯜꯂꯛꯀꯅꯤ
হঞ্জিল্লক্লে	ꯍꯟꯖꯤꯜꯂꯛꯂꯦ
হনখিনবা	ꯍꯟꯈꯤꯅꯕ
হনগৎনা	ꯍꯟꯒꯠꯅ
হনজিন্না	ꯍꯟꯖꯤꯟꯅꯥ
হনবগী	ꯍꯟꯕꯒꯤ
হনবা	ꯍꯟꯕꯥ
হনুবা	ꯍꯅꯨꯕꯥ
হনুবী	ꯍꯅꯨꯕꯤ
হন্থখি	ꯍꯟꯊꯈꯤ
হন্থখিবগা	ꯍꯟꯊꯈꯤꯕꯒꯥ
হন্থখ্রে	ꯍꯟꯊꯈ꯭ꯔꯦ
হন্থগনি	ꯍꯟꯊꯒꯅꯤ
হন্থদুনা	ꯍꯟꯊꯗꯨꯅꯥ
হন্থনবা	ꯍꯟꯊꯅꯕꯥ
হন্থনা	ꯍꯟꯊꯅꯥ
হন্থবগী	ꯍꯟꯊꯕꯒꯤ
হন্থবা	ꯍꯟꯊꯕꯥ
হন্থরকপগা	ꯍꯟꯊꯔꯛꯄꯒꯥ
হন্থরকপগী	ꯍꯟꯊꯔꯛꯄꯒꯤ
হন্থরকপগুম	ꯍꯟꯊꯔꯛꯄꯒꯨꯝ
হন্থরকপদা	ꯍꯟꯊꯔꯛꯄꯗꯥ
হন্থরকপা	ꯍꯟꯊꯔꯛꯄꯥ
হন্থরক্কনি	ꯍꯟꯊꯔꯛꯀꯅꯤ
হন্থরক্লগা	ꯍꯟꯊꯔꯛꯂꯒꯥ
হন্থরক্লি	ꯍꯟꯊꯔꯛꯂꯤ
হন্থরক্লে	ꯍꯟꯊꯔꯛꯂꯦ
হন্থরগনি	ꯍꯟꯊꯔꯒꯅꯤ
হন্থরগা	ꯍꯟꯊꯔꯒꯥ
হন্থরবদি	ꯍꯟꯊꯔꯕꯗꯤ
হন্থরি	ꯍꯟꯊꯔꯤ
হন্থরিবা	ꯍꯟꯊꯔꯤꯕꯥ
হন্থরুরবা	ꯍꯟꯊꯔꯨꯔꯕꯥ
হন্থরে	ꯍꯟꯊꯔꯦ
হন্থহনগনি	ꯍꯟꯊꯍꯟꯒꯅꯤ
হন্থহনবতা	ꯍꯟꯊꯍꯟꯕꯇꯥ
হন্থহনবদা	ꯍꯟꯊꯍꯟꯕꯗꯥ
হন্থহনবা	ꯍꯟꯊꯍꯟꯕꯥ
হন্থহন্নবা	ꯍꯟꯊꯍꯟꯅꯕꯥ
হন্থহল্লগা	ꯍꯟꯊꯍꯜꯂꯒꯥ
হন্থৈ	ꯍꯟꯊꯩ
হন্দক	ꯍꯟꯗꯛ
হন্দকসু	ꯍꯟꯗꯛꯁꯨ
হন্দকী	ꯍꯟꯗꯀꯤ
হন্দক্কি	ꯍꯟꯗꯛꯀꯤ
হন্দক্কী	ꯍꯟꯗꯛꯀꯤ
হন্দক্না	ꯍꯟꯗꯛꯅꯥ
হন্দা	ꯍꯟꯗꯥ
হন্দুনা	ꯍꯟꯗꯨꯅꯥ
হন্দ্রেদ	ꯍꯟꯗ꯭ꯔꯦꯗ
হন্ন	ꯍꯟꯅ
হন্নখ্রে	ꯍꯟꯅꯈ꯭ꯔꯦ
হন্নগী	ꯍꯟꯅꯒꯤ
হন্নবা	ꯍꯟꯅꯕꯥ
হন্নরক্লে	ꯍꯟꯅꯔꯛꯂꯦ
হন্না	ꯍꯟꯅꯥ
হপ্তা	ꯍꯞꯇꯥ
হবেলি	ꯍꯕꯦꯂꯤ
হর	ꯍꯔ
হরদিপ	ꯍꯔꯗꯤꯞ
হরাও	ꯍꯔꯥꯎ
হরাওজৈ	ꯍꯔꯥꯑꯣꯖꯩ
হরাওনা	ꯍꯔꯥꯎꯅꯥ
হরাওবগা	ꯍꯔꯥꯑꯣꯕꯒꯥ
হরাওবগী	ꯍꯔꯥꯎꯕꯒꯤ
হরাওবদা	ꯍꯔꯥꯑꯣꯕꯗꯥ
হরাওবনা	ꯍꯔꯥꯑꯣꯕꯅꯥ
হরাওবা	ꯍꯔꯥꯎꯕꯥ
হরাসমেন্ট	ꯍꯔꯥꯁꯃꯦꯟꯇ
হরি	ꯍꯔꯤ
হরিকুমার	ꯍꯔꯤꯀꯨꯃꯥꯔ
হরিয়ানা	ꯍꯔꯤꯌꯥꯅꯥ
হরিয়ানাদা	ꯍꯔꯤꯌꯥꯅꯥꯗꯥ
হরে	ꯍꯔꯦ
হরেকৃষ্ণ	ꯍꯔꯦꯀ꯭ꯔꯤꯁꯅ
হরেকৃষ্ণনা	ꯍꯔꯦꯀ꯭ꯔꯁꯅꯥ
হর্দিপ	ꯍꯔꯗꯤꯞ
হর্স	ꯍꯔꯁ
হলহনখ্রে	ꯍꯜꯍꯟꯈ꯭ꯔꯦ
হল্লকখি	ꯍꯜꯂꯛꯈꯤ
হল্লকখিবনি	ꯍꯜꯂꯛꯈꯤꯕꯅꯤ
হল্লকখিবা	ꯍꯜꯂꯛꯈꯤꯕꯥ
হল্লকখ্রবা	ꯍꯜꯂꯛꯈ꯭ꯔꯕꯥ
হল্লকখ্রে	ꯍꯜꯂꯛꯈ꯭ꯔꯦ
হল্লকপগী	ꯍꯜꯂꯛꯄꯒꯤ
হল্লকপদা	ꯍꯜꯂꯛꯄꯗꯥ
হল্লকপনি	ꯍꯜꯂꯛꯄꯅꯤ
হল্লকপা	ꯍꯜꯂꯛꯄꯥ
হল্লক্কদবা	ꯍꯜꯂꯛꯀꯗꯕꯥ
হল্লক্কনি	ꯍꯜꯂꯛꯀꯅꯤ
হল্লক্নবা	ꯍꯜꯂꯛꯅꯕꯥ
হল্লক্লগা	ꯍꯜꯂꯛꯂꯒꯥ
হল্লক্লবদি	ꯍꯜꯂꯛꯂꯕꯗꯤ
হল্লক্লবা	ꯍꯜꯂꯛꯂꯕꯥ
হল্লক্লে	ꯍꯜꯂꯛꯂꯦ
হল্লি	ꯍꯜꯂꯤ
হল্লে	ꯍꯜꯂꯦ
হসিনা	ꯍꯁꯤꯅꯥ
হসিনানা	ꯍꯁꯤꯅꯥꯅꯥ
হা	ꯍꯥ
হাংখি	ꯍꯥꯡꯈꯤ
হাংখিবনি	ꯍꯥꯡꯈꯤꯕꯅꯤ
হাংখ্রে	ꯍꯥꯡꯈ꯭ꯔꯦ
হাংগদবনি	ꯍꯥꯡꯒꯗꯕꯅꯤ
হাংগনি	ꯍꯥꯡꯒꯅꯤ
হাংদুনা	ꯍꯥꯡꯗꯨꯅꯥ
হাংদ্রে	ꯍꯥꯡꯗ꯭ꯔꯦ
হাংনদ্রে	ꯍꯥꯡꯅꯗ꯭ꯔꯦ
হাংনবগী	ꯍꯥꯡꯅꯕꯒꯤ
হাংনবা	ꯍꯥꯡꯅꯕꯥ
হাংনরি	ꯍꯥꯡꯅꯔꯤ
হাংবগা	ꯍꯥꯡꯕꯒꯥ
হাংবগী	ꯍꯥꯡꯕꯒꯤ
হাংবদা	ꯍꯥꯡꯕꯗꯥ
হাংবা	ꯍꯥꯡꯕꯥ
হাংলবা	ꯍꯥꯡꯂꯕꯥ
হাংলম্বা	ꯍꯥꯡꯂꯝꯕꯥ
হাংলিবা	ꯍꯥꯡꯂꯤꯕꯥ
হাংলে	ꯍꯥꯡꯂꯦ
হাই	ꯍꯥꯏ
হাইগৎতুনা	ꯍꯥꯏꯒꯠꯇꯨꯅꯥ
হাইজিন	ꯍꯥꯏꯖꯤꯟ
হাইদুনা	ꯍꯥꯏꯗꯨꯅꯥ
হাইদ্রবাদ	ꯍꯥꯏꯗ꯭ꯔꯕꯥꯗ
হাইদ্রবাদকী	ꯍꯥꯏꯗ꯭ꯔꯕꯥꯗꯀꯤ
হাইপরটেন্সন	ꯍꯥꯏꯄꯔꯇꯦꯟꯁꯟ
হাইরদুনা	ꯍꯥꯏꯔꯗꯨꯅꯥ
হাইরপ	ꯍꯥꯏꯔꯞ
হাইৱে	ꯍꯥꯏꯋꯦ
হাইৱেশিংদা	ꯍꯥꯏꯋꯦꯁꯤꯡꯗꯥ
হাও	ꯍꯥꯑꯣ
হাওকিপ	ꯍꯥꯑꯣꯀꯤꯞ
হাওকিপকী	ꯍꯥꯑꯣꯀꯤꯞꯀꯤ
হাওকিপনা	ꯍꯥꯑꯣꯀꯤꯞꯅꯥ
হাওকিপনি	ꯍꯥꯑꯣꯀꯤꯞꯅꯤ
হাওকিপসু	ꯍꯥꯑꯣꯀꯤꯞꯁꯨ
হাওখা	ꯍꯥꯑꯣꯈꯥ
হাওদি	ꯍꯥꯑꯣꯗꯤ
হাওনা	ꯍꯥꯑꯣꯅꯥ
হাওপু	ꯍꯥꯑꯣꯄꯨ
হাওবম	ꯍꯥꯑꯣꯕꯝ
হাওবমনা	ꯍꯥꯑꯣꯕꯝꯅꯥ
হাওবা	ꯍꯥꯑꯣꯕꯥ
হাওরৈবী	ꯍꯥꯑꯣꯔꯩꯕꯤ
হাওরৈবীদগী	ꯍꯥꯑꯣꯔꯩꯕꯤꯗꯒꯤ
হাওস	ꯍꯥꯑꯣꯁ
হাওসকী	ꯍꯥꯑꯣꯁꯀꯤ
হাওসতা	ꯍꯥꯑꯣꯁꯇꯥ
হাওসনি	ꯍꯥꯑꯣꯁꯅꯤ
হাওসশিংগী	ꯍꯥꯑꯣꯁꯁꯤꯡꯒꯤ
হাওসশিংদা	ꯍꯥꯑꯣꯁꯁꯤꯡꯗꯥ
হাওসশিংনা	ꯍꯥꯑꯣꯁꯁꯤꯡꯅꯥ
হাকথি	ꯍꯥꯛꯊꯤ
হাক্না	ꯍꯥꯛꯅꯥ
হাখি	ꯍꯥꯈꯤ
হাথু	ꯍꯥꯊꯨ
হাদা	ꯍꯥꯗꯥ
হানখি	ꯍꯥꯟꯈꯤ
হানবা	ꯍꯥꯟꯕꯥ
হান্নগা	ꯍꯥꯟꯅꯒꯥ
হান্নগী	ꯍꯥꯟꯅꯒꯤ
হান্নগীদু	ꯍꯥꯟꯅꯒꯤꯗꯨ
হান্নগুম	ꯍꯥꯟꯅꯒꯨꯝ
হান্নগুম্না	ꯍꯥꯟꯅꯒꯨꯝꯅꯥ
হান্নদগী	ꯍꯥꯟꯅꯗꯒꯤ
হান্নদি	ꯍꯥꯟꯅꯗꯤ
হান্ননা	ꯍꯥꯟꯅꯅꯥ
হান্নসু	ꯍꯥꯟꯅꯁꯨ
হান্না	ꯍꯥꯟꯅꯥ
হাপকদবনি	ꯍꯥꯄꯛꯗꯕꯅꯤ
হাপকনি	ꯍꯥꯄꯛꯅꯤ
হাপকৎপা	ꯍꯥꯞꯀꯠꯄꯥ
হাপখি	ꯍꯥꯞꯈꯤ
হাপখিবগী	ꯍꯥꯞꯈꯤꯕꯒꯤ
হাপখিবা	ꯍꯥꯞꯈꯤꯕꯥ
হাপখ্রে	ꯍꯥꯞꯈ꯭ꯔꯦ
হাপচিনখি	ꯍꯥꯞꯆꯤꯟꯈꯤ
হাপচিনখিবনি	ꯍꯥꯞꯆꯤꯟꯈꯤꯕꯅꯤ
হাপচিনখ্রে	ꯍꯥꯞꯆꯤꯟꯈ꯭ꯔꯦ
হাপচিনগদবনি	ꯍꯥꯞꯆꯤꯟꯒꯗꯕꯅꯤ
হাপচিনগনি	ꯍꯥꯞꯆꯤꯟꯒꯅꯤ
হাপচিনবা	ꯍꯥꯞꯆꯤꯟꯕꯥ
হাপচিন্দুনা	ꯍꯥꯞꯆꯤꯟꯗꯨꯅꯥ
হাপচিল্লবা	ꯍꯥꯞꯆꯤꯜꯂꯕꯥ
হাপ্তুনা	ꯍꯥꯞꯇꯨꯅꯥ
হাপ্ননবা	ꯍꯥꯞꯅꯅꯕꯥ
হাপ্নবা	ꯍꯥꯞꯅꯕꯥ
হাপ্পগা	ꯍꯥꯞꯄꯒꯥ
হাপ্পগী	ꯍꯥꯞꯄꯒꯤ
হাপ্পদা	ꯍꯥꯞꯄꯗꯥ
হাপ্পা	ꯍꯥꯞꯄꯥ
হাপ্পী	ꯍꯥꯞꯄꯤ
হাপ্লকপা	ꯍꯥꯞꯂꯛꯄꯥ
হাপ্লগনি	ꯍꯥꯞꯂꯒꯅꯤ
হাপ্লগা	ꯍꯥꯞꯂꯒꯥ
হাপ্লবা	ꯍꯥꯞꯂꯕꯥ
হাপ্লম্বা	ꯍꯥꯞꯂꯝꯕꯥ
হাপ্লি	ꯍꯥꯞꯂꯤ
হাপ্লিবা	ꯍꯥꯞꯂꯤꯕꯥ
হাফ	ꯍꯥꯐ
হাবদগী	ꯍꯥꯕꯗꯒꯤ
হাবা	ꯍꯥꯕꯥ
হাম্বা	ꯍꯥꯝꯕꯥ
হার	ꯍꯥꯔ
হারগী	ꯍꯥꯔꯒꯤ
হারি	ꯍꯥꯔꯤ
হার্ট	ꯍꯥꯔꯇ
হাসন	ꯍꯥꯁꯟ
হাৎখি	ꯍꯥꯠꯈꯤ
হাৎখিবগী	ꯍꯥꯠꯈꯤꯕꯒꯤ
হাৎখিবনি	ꯍꯥꯠꯈꯤꯕꯅꯤ
হাৎখিবা	ꯍꯥꯠꯈꯤꯕꯥ
হাৎখ্রে	ꯍꯥꯠꯈ꯭ꯔꯦ
হাৎতুনা	ꯍꯥꯠꯇꯨꯅꯥ
হাৎনবা	ꯍꯥꯠꯅꯕꯥ
হাৎপগী	ꯍꯥꯠꯄꯒꯤ
হাৎপদা	ꯍꯥꯠꯄꯗꯥ
হাৎপনচিংবা	ꯍꯥꯠꯄꯅꯆꯤꯡꯕꯥ
হাৎপা	ꯍꯥꯠꯄꯥ
হাৎলগা	ꯍꯥꯠꯂꯒꯥ
হাৎলবা	ꯍꯥꯠꯂꯕꯥ
হাৎলম্বগী	ꯍꯥꯠꯂꯝꯕꯒꯤ
হাৎলি	ꯍꯥꯠꯂꯤ
হায়	ꯍꯥꯌ
হায়খি	ꯍꯥꯌꯈꯤ
হায়খিবদু	ꯍꯥꯌꯈꯤꯕꯗꯨ
হায়খিবনি	ꯍꯥꯌꯈꯤꯕꯅꯤ
হায়খিবা	ꯍꯥꯌꯈꯤꯕꯥ
হায়খ্রবনি	ꯍꯥꯌꯈ꯭ꯔꯕꯅꯤ
হায়খ্রে	ꯍꯥꯌꯈ꯭ꯔꯦ
হায়গৎলকপা	ꯍꯥꯌꯒꯠꯂꯛꯄꯥ
হায়গৎলক্লে	ꯍꯥꯌꯒꯠꯂꯛꯂꯦ
হায়জখি	ꯍꯥꯌꯖꯈꯤ
হায়জখিবা	ꯍꯥꯌꯖꯈꯤꯕꯥ
হায়জখ্রে	ꯍꯥꯌꯖꯈ꯭ꯔꯦ
হায়জগদবনি	ꯍꯥꯌꯖꯒꯗꯕꯅꯤ
হায়জদুনা	ꯍꯥꯌꯖꯗꯨꯅꯥ
হায়জবা	ꯍꯥꯌꯖꯕꯥ
হায়জরকপদগী	ꯍꯥꯌꯖꯔꯛꯄꯗꯒꯤ
হায়জরকপা	ꯍꯥꯌꯖꯔꯛꯄꯥ
হায়জরগনি	ꯍꯥꯌꯖꯔꯒꯅꯤ
হায়জরি	ꯍꯥꯌꯖꯔꯤ
হায়জরিবা	ꯍꯥꯌꯖꯔꯤꯕꯥ
হায়জরুবদা	ꯍꯥꯌꯖꯔꯨꯕꯗꯥ
হায়ট	ꯍꯥꯌꯇ
হায়দু	ꯍꯥꯌꯗꯨ
হায়দুনসু	ꯍꯥꯌꯗꯨꯅꯁꯨ
হায়দুনা	ꯍꯥꯌꯗꯨꯅꯥ
হায়দ্রবাদ	ꯍꯥꯌꯗ꯭ꯔꯕꯥꯗ
হায়দ্রবাদকী	ꯍꯥꯌꯗ꯭ꯔꯕꯥꯗꯀꯤ
হায়দ্রবাদতা	ꯍꯥꯌꯗ꯭ꯔꯕꯥꯗꯇꯥ
হায়ন	ꯍꯥꯌꯅ
হায়নরক্লিবা	ꯍꯥꯌꯅꯔꯛꯂꯤꯕꯥ
হায়নরম্বদগী	ꯍꯥꯌꯅꯔꯝꯕꯗꯒꯤ
হায়নরি	ꯍꯥꯌꯅꯔꯤ
হায়নরিঙৈ	ꯍꯥꯌꯅꯔꯤꯉꯩ
হায়নরিবা	ꯍꯥꯌꯅꯔꯤꯕꯥ
হায়নসু	ꯍꯥꯌꯅꯁꯨ
হায়না	ꯍꯥꯌꯅꯥ
হায়ফম	ꯍꯥꯌꯐꯝ
হায়ব	ꯍꯥꯌꯕ
হায়বগী	ꯍꯥꯌꯕꯒꯤ
হায়বগীদমক	ꯍꯥꯌꯕꯒꯤꯗꯃꯛ
হায়বদগী	ꯍꯥꯌꯕꯗꯒꯤ
হায়বদা	ꯍꯥꯌꯕꯗꯥ
হায়বদি	ꯍꯥꯌꯕꯗꯤ
হায়বদু	ꯍꯥꯌꯕꯗꯨ
হায়বদুগী	ꯍꯥꯌꯕꯗꯨꯒꯤ
হায়বদুদি	ꯍꯥꯌꯕꯗꯨꯗꯤ
হায়বদুনা	ꯍꯥꯌꯕꯗꯨꯅꯥ
হায়বদুনি	ꯍꯥꯌꯕꯗꯨꯅꯤ
হায়বদুসু	ꯍꯥꯌꯕꯗꯨꯁꯨ
হায়বনচিংবগী	ꯍꯥꯌꯕꯅꯆꯤꯡꯕꯒꯤ
হায়বনচিংবা	ꯍꯥꯌꯕꯟꯆꯤꯡꯕꯥ
হায়বনি	ꯍꯥꯌꯕꯅꯤ
হায়ববু	ꯍꯥꯌꯕꯕꯨ
হায়বসি	ꯍꯥꯌꯕꯁꯤ
হায়বসিগী	ꯍꯥꯌꯕꯁꯤꯒꯤ
হায়বসিদা	ꯍꯥꯌꯕꯁꯤꯗꯥ
হায়বসিদি	ꯍꯥꯌꯕꯁꯤꯗꯤ
হায়বসিনা	ꯍꯥꯌꯕꯁꯤꯅꯥ
হায়বসিনি	ꯍꯥꯌꯕꯁꯤꯅꯤ
হায়বসিমক	ꯍꯥꯌꯕꯁꯤꯃꯛ
হায়বসিসু	ꯍꯥꯌꯕꯁꯤꯁꯨ
হায়বসু	ꯍꯥꯌꯕꯁꯨ
হায়বা	ꯍꯥꯌꯕꯥ
হায়র	ꯍꯥꯌꯔ
হায়রকখি	ꯍꯥꯌꯔꯛꯈꯤ
হায়রকপগী	ꯍꯥꯌꯔꯛꯄꯒꯤ
হায়রকপদগী	ꯍꯥꯌꯔꯛꯄꯗꯒꯤ
হায়রকপদা	ꯍꯥꯌꯔꯛꯄꯗꯥ
হায়রকপা	ꯍꯥꯌꯔꯛꯄꯥ
হায়রক্লবদি	ꯍꯥꯌꯔꯛꯂꯕꯗꯤ
হায়রক্লি	ꯍꯥꯌꯔꯛꯂꯤ
হায়রক্লিবা	ꯍꯥꯌꯔꯛꯂꯤꯕꯥ
হায়রক্লে	ꯍꯥꯌꯔꯛꯂꯦ
হায়রগসু	ꯍꯥꯌꯔꯒꯁꯨ
হায়রগা	ꯍꯥꯌꯔꯒꯥ
হায়রদুনা	ꯍꯥꯌꯔꯗꯨꯅꯥ
হায়রবদা	ꯍꯥꯌꯔꯕꯗꯥ
হায়রবদি	ꯍꯥꯌꯔꯕꯗꯤ
হায়রবনিনা	ꯍꯥꯌꯔꯕꯅꯤꯅꯥ
হায়রবসু	ꯍꯥꯌꯔꯕꯁꯨ
হায়রবা	ꯍꯥꯌꯔꯕꯥ
হায়রি	ꯍꯥꯌꯔꯤ
হায়রিব	ꯍꯥꯌꯔꯤꯕ
হায়রিবদু	ꯍꯥꯌꯔꯤꯕꯗꯨ
হায়রিবশিং	ꯍꯥꯌꯔꯤꯕꯁꯤꯡ
হায়রিবসি	ꯍꯥꯌꯔꯤꯕꯁꯤ
হায়রিবসিনা	ꯍꯥꯌꯔꯤꯕꯁꯤꯅꯥ
হায়রিবা	ꯍꯥꯌꯔꯤꯕꯥ
হায়রুবদা	ꯍꯥꯌꯔꯨꯕꯗꯥ
হায়ৱে	ꯍꯥꯌꯋꯦ
হায়ৱেজগী	ꯍꯥꯌꯋꯦꯖꯒꯤ
হায়ৱেদা	ꯍꯥꯌꯋꯦꯗꯥ
হায়ৱেশিং	ꯍꯥꯌꯋꯦꯁꯤꯡ
হায়ৱেশিংদা	ꯍꯥꯌꯋꯦꯁꯤꯡꯗꯥ
হি	ꯍꯤ
হিংগদগে	ꯍꯤꯡꯒꯗꯒꯦ
হিংগদবনি	ꯍꯤꯡꯒꯗꯕꯅꯤ
হিংচাবীনি	ꯍꯤꯪꯆꯥꯕꯤꯅꯤ
হিংজনবা	ꯍꯤꯡꯖꯟꯕꯥ
হিংজবা	ꯍꯤꯡꯖꯕꯥ
হিংননবগী	ꯍꯤꯡꯅꯅꯕꯒꯤ
হিংননবা	ꯍꯤꯡꯅꯅꯕꯥ
হিংনবগী	ꯍꯤꯡꯅꯕꯒꯤ
হিংনবা	ꯍꯤꯡꯅꯕꯥ
হিংনা	ꯍꯤꯪꯅꯥ
হিংবগী	ꯍꯤꯡꯕꯒꯤ
হিংবদা	ꯍꯤꯡꯕꯗꯥ
হিংবা	ꯍꯤꯡꯕꯥ
হিংমিন্নগদবনি	ꯍꯤꯡꯃꯤꯟꯅꯒꯗꯕꯅꯤ
হিংমিন্ননবা	ꯍꯤꯡꯃꯤꯟꯅꯅꯕꯥ
হিংমিন্নবগী	ꯍꯤꯡꯃꯤꯟꯅꯕꯒꯤ
হিংমিন্নবা	ꯍꯤꯡꯃꯤꯟꯅꯕꯥ
হিংমিন্নরি	ꯍꯤꯡꯃꯤꯟꯅꯔꯤ
হিংমিন্নরিবা	ꯍꯤꯡꯃꯤꯟꯅꯔꯤꯕꯥ
হিংলবদি	ꯍꯤꯡꯂꯕꯗꯤ
হিংলি	ꯍꯤꯡꯂꯤ
হিংলিঙৈ	ꯍꯤꯡꯂꯤꯉꯩ
হিংলিঙৈদা	ꯍꯤꯡꯂꯤꯉꯩꯗꯥ
হিংলিবা	ꯍꯤꯡꯂꯤꯕꯥ
হিংশা	ꯍꯤꯡꯁꯥ
হিংশাগী	ꯍꯤꯡꯁꯥꯒꯤ
হিংহনবদা	ꯍꯤꯡꯍꯟꯕꯗꯥ
হিংহনবা	ꯍꯤꯡꯍꯟꯕꯥ
হিংহল্লিবা	ꯍꯤꯡꯍꯜꯂꯤꯕꯥ
হিগী	ꯍꯤꯒꯤ
হিচম	ꯍꯤꯆꯝ
হিজবুল	ꯍꯤꯖꯕꯨꯂ
হিজম	ꯍꯤꯖꯝ
হিট	ꯍꯤꯇ
হিটলর	ꯍꯤꯇꯂꯔ
হিথাংফম	ꯍꯤꯊꯥꯡꯐꯝ
হিথাংফমদা	ꯍꯤꯊꯥꯡꯐꯝꯗꯥ
হিদাক	ꯍꯤꯗꯥꯛ
হিদাকনি	ꯍꯤꯗꯥꯛꯅꯤ
হিদাকশিং	ꯍꯤꯗꯥꯛꯁꯤꯡ
হিদাকসু	ꯍꯤꯗꯥꯛꯁꯨ
হিদেন	ꯍꯤꯗꯦꯟ
হিদেন্দা	ꯍꯤꯗꯦꯟꯗꯥ
হিন্দি	ꯍꯤꯟꯗꯤ
হিন্দিদা	ꯍꯤꯟꯗꯤꯗꯥ
হিন্দু	ꯍꯤꯟꯗꯨ
হিন্দুশিংগী	ꯍꯤꯟꯗꯨꯁꯤꯡꯒꯤ
হিন্দুষ্টানি	ꯍꯤꯟꯗꯨꯁꯇꯥꯟꯅꯤ
হিন্দুস্তান	ꯍꯤꯟꯗꯨꯁꯇꯥꯟ
হিপ্পা	ꯍꯤꯞꯄꯥ
হিমন্ত	ꯍꯤꯃꯟꯇ
হিমাচল	ꯍꯤꯃꯥꯆꯜ
হিমালয়	ꯍꯤꯃꯥꯂꯌ
হিমালয়ান	ꯍꯤꯃꯥꯂꯌꯥꯟ
হিমায়	ꯍꯤꯃꯥꯌ
হিরম	ꯍꯤꯔꯝ
হিরমদা	ꯍꯤꯔꯝꯗꯥ
হিরমশিংদা	ꯍꯤꯔꯝꯁꯤꯡꯗꯥ
হিরেন	ꯍꯤꯔꯦꯟ
হিল	ꯍꯤꯜ
হিলস	ꯍꯤꯜꯁ
হিলসকী	ꯍꯤꯜꯁꯀꯤ
হিষ্ট্রি	ꯍꯤꯁꯇ꯭ꯔꯤ
হিয়াং	ꯍꯤꯌꯥꯡ
হিয়াংথাং	ꯍꯤꯌꯥꯡꯊꯥꯡ
হিয়াংলম	ꯍꯤꯌꯥꯡꯂꯝ
হিয়াঙ্গৈ	ꯍꯤꯌꯥꯡꯒꯩ
হিয়ারিং	ꯍꯤꯌꯥꯔꯤꯡ
হীদাক	ꯍꯤꯗꯥꯛ
হীদাক্কী	ꯍꯤꯗꯥꯛꯀꯤ
হীপ্লগা	ꯍꯤꯄꯂ꯭ꯒꯥ
হীরম	ꯍꯤꯔꯝ
হীরমদা	ꯍꯤꯔꯝꯗꯥ
হীরমদি	ꯍꯤꯔꯝꯗꯤ
হীরমশিং	ꯍꯤꯔꯝꯁꯤꯡ
হীরমশিংগী	ꯍꯤꯔꯝꯁꯤꯡꯒꯤ
হীরমশিংদা	ꯍꯤꯔꯝꯁꯤꯡꯗꯥ
হীরমশিংদি	ꯍꯤꯔꯝꯁꯤꯡꯗꯤ
হীরমসিদা	ꯍꯤꯔꯝꯁꯤꯗꯥ
হু	ꯍꯨ
হুই	ꯍꯨꯏ
হুইগী	ꯍꯨꯏꯒꯤ
হুইরেম	ꯍꯨꯏꯔꯦꯃ
হুইশিং	ꯍꯨꯏꯁꯤꯡ
হুইয়েন	ꯍꯨꯏꯌꯦꯟ
হুকুম	ꯍꯨꯀꯨꯝ
হুগী	ꯍꯨꯒꯤ
হুদা	ꯍꯨꯗꯥ
হুনখি	ꯍꯨꯟꯈꯤ
হুনখিবনি	ꯍꯨꯟꯈꯤꯕꯅꯤ
হুনখিবা	ꯍꯨꯟꯈꯤꯕꯥ
হুনখ্রবনি	ꯍꯨꯟꯅꯈ꯭ꯔꯕꯅꯤ
হুনবা	ꯍꯨꯟꯕꯥ
হুন্দুনা	ꯍꯨꯟꯗꯨꯅꯥ
হুন্নবগী	ꯍꯨꯟꯅꯕꯒꯤ
হুন্নবা	ꯍꯨꯟꯅꯕꯥ
হুপ্না	ꯍꯨꯞꯅꯥ
হুবা	ꯍꯨꯕꯥ
হুবৈ	ꯍꯨꯕꯩ
হুম	ꯍꯨꯃ
হুমদ্রা	ꯍꯨꯃꯗꯔꯥ
হুমনা	ꯍꯨꯝꯅꯥ
হুমনি	ꯍꯨꯝꯅꯤ
হুমনিদা	ꯍꯨꯝꯅꯤꯗꯥ
হুমাং	ꯍꯨꯃꯥꯡ
হুমেন	ꯍꯨꯃꯦꯟ
হুম্নি	ꯍꯨꯝꯅꯤ
হুম্নিগী	ꯍꯨꯝꯅꯤꯒꯤ
হুম্ফু	ꯍꯨꯝꯐꯨ
হুম্বগী	ꯍꯨꯝꯕꯒꯤ
হুরান	ꯍꯨꯔꯥꯟ
হুরানবা	ꯍꯨꯔꯥꯟꯕꯥ
হুরাল্লকপা	ꯍꯨꯔꯥꯜꯂꯛꯄꯥ
হুল্লকখি	ꯍꯨꯜꯂꯛꯈꯤ
হুল্লদুনা	ꯍꯨꯜꯂꯗꯨꯅꯥ
হুল্লিবা	ꯍꯨꯜꯂꯤꯕꯥ
হুৎপা	ꯍꯨꯠꯄꯥ
হে	ꯍꯦ
হেংলেপ	ꯍꯦꯡꯂꯦꯞ
হেক	ꯍꯦꯛ
হেদ	ꯍꯦꯗ
হেদমাষ্টর	ꯍꯦꯗꯃꯥꯁꯇ꯭ꯔ
হেদলাইন	ꯍꯦꯗꯂꯥꯏꯟ
হেন	ꯍꯦꯟ
হেনখি	ꯍꯦꯟꯈꯤ
হেনখিবগা	ꯍꯦꯟꯈꯤꯕꯒꯥ
হেনখ্রে	ꯍꯦꯟꯈ꯭ꯔꯦ
হেনগনি	ꯍꯦꯟꯒꯅꯤ
হেনগৎকনি	ꯍꯦꯟꯒꯠꯀꯅꯤ
হেনগৎখি	ꯍꯦꯟꯒꯠꯈꯤ
হেনগৎখিবনি	ꯍꯦꯟꯒꯠꯈꯤꯕꯅꯤ
হেনগৎখ্রে	ꯍꯦꯟꯒꯠꯈ꯭ꯔꯦ
হেনগৎতুনা	ꯍꯦꯟꯒꯠꯇꯨꯅꯥ
হেনগৎনবগী	ꯍꯦꯟꯒꯠꯅꯕꯒꯤ
হেনগৎনবা	ꯍꯦꯟꯒꯠꯅꯕꯥ
হেনগৎনা	ꯍꯦꯟꯒꯠꯅꯥ
হেনগৎপগা	ꯍꯦꯟꯒꯠꯄꯒꯥ
হেনগৎপগী	ꯍꯦꯟꯒꯠꯄꯒꯤ
হেনগৎপদা	ꯍꯦꯟꯒꯠꯄꯗꯥ
হেনগৎপনি	ꯍꯦꯟꯒꯠꯄꯅꯤ
হেনগৎপা	ꯍꯦꯟꯒꯠꯄꯥ
হেনগৎলকখি	ꯍꯦꯟꯒꯠꯂꯛꯈꯤ
হেনগৎলকখিবনি	ꯍꯦꯟꯒꯠꯂꯛꯈꯤꯕꯅꯤ
হেনগৎলকখ্রে	ꯍꯦꯟꯒꯠꯂꯛꯈ꯭ꯔꯦ
হেনগৎলকপগা	ꯍꯦꯟꯒꯠꯂꯛꯄꯒꯥ
হেনগৎলকপগী	ꯍꯦꯟꯒꯠꯂꯛꯄꯒꯤ
হেনগৎলকপদগী	ꯍꯦꯟꯒꯠꯂꯛꯄꯗꯒꯤ
হেনগৎলকপদা	ꯍꯦꯟꯒꯠꯂꯛꯄꯗꯥ
হেনগৎলকপনা	ꯍꯦꯟꯒꯠꯂꯛꯄꯅꯥ
হেনগৎলকপনি	ꯍꯦꯟꯒꯠꯂꯛꯄꯅꯤ
হেনগৎলকপসু	ꯍꯦꯟꯒꯠꯂꯛꯄꯁꯨ
হেনগৎলকপা	ꯍꯦꯟꯒꯠꯂꯛꯄꯥ
হেনগৎলক্কদবা	ꯍꯦꯟꯒꯠꯂꯛꯀꯗꯕꯥ
হেনগৎলক্কনি	ꯍꯦꯟꯒꯠꯂꯛꯀꯅꯤ
হেনগৎলক্লবদি	ꯍꯦꯟꯒꯠꯂꯛꯂꯕꯗꯤ
হেনগৎলক্লবসু	ꯍꯦꯟꯒꯠꯂꯛꯂꯕꯁꯨ
হেনগৎলক্লি	ꯍꯦꯟꯒꯠꯂꯛꯂꯤ
হেনগৎলক্লিবনি	ꯍꯦꯟꯒꯠꯂꯛꯂꯤꯕꯅꯤ
হেনগৎলক্লিবা	ꯍꯦꯟꯒꯠꯂꯛꯂꯤꯕꯥ
হেনগৎলক্লে	ꯍꯦꯟꯒꯠꯂꯛꯂꯦ
হেনগৎলগনি	ꯍꯦꯟꯒꯠꯂꯒꯅꯤ
হেনগৎলবসু	ꯍꯦꯟꯒꯠꯂꯕꯁꯨ
হেনগৎলে	ꯍꯦꯟꯒꯠꯂꯦ
হেনগৎহনখিবা	ꯍꯦꯟꯒꯠꯍꯟꯈꯤꯕꯥ
হেনগৎহনগদবনি	ꯍꯦꯟꯒꯠꯍꯟꯒꯗꯕꯅꯤ
হেনগৎহনগনি	ꯍꯦꯟꯒꯠꯍꯟꯒꯅꯤ
হেনগৎহনবগা	ꯍꯦꯟꯒꯠꯍꯟꯕꯒꯥ
হেনগৎহনবগী	ꯍꯦꯟꯒꯠꯍꯟꯕꯒꯤ
হেনগৎহনবা	ꯍꯦꯟꯒꯠꯍꯟꯕꯥ
হেনগৎহন্দুনা	ꯍꯦꯟꯒꯠꯍꯟꯗꯨꯅꯥ
হেনগৎহন্নবগী	ꯍꯦꯟꯒꯠꯍꯟꯅꯕꯒꯤ
হেনগৎহন্নবা	ꯍꯦꯟꯒꯠꯍꯟꯅꯕꯥ
হেনগৎহল্লকপা	ꯍꯦꯟꯒꯠꯍꯜꯂꯛꯄꯥ
হেনগৎহল্লি	ꯍꯦꯟꯒꯠꯍꯜꯂꯤ
হেনগৎহল্লে	ꯍꯦꯟꯒꯠꯍꯜꯂꯦ
হেনজিন্না	ꯍꯦꯟꯖꯤꯟꯅꯥ
হেনজিল্লক্লি	ꯍꯦꯟꯖꯤꯜꯂꯛꯂꯤ
হেনবগা	ꯍꯦꯟꯕꯒꯥ
হেনবগী	ꯍꯦꯟꯕꯒꯤ
হেনবদগী	ꯍꯦꯟꯕꯗꯒꯤ
হেনবদা	ꯍꯦꯟꯕꯗꯥ
হেনবনা	ꯍꯦꯟꯕꯅꯥ
হেনবসিদা	ꯍꯦꯟꯕꯁꯤꯗꯥ
হেনবসু	ꯍꯦꯟꯕꯁꯨ
হেনবা	ꯍꯦꯟꯕꯥ
হেনরি	ꯍꯦꯟꯔꯤ
হেনরিনা	ꯍꯦꯟꯔꯤꯅꯥ
হেন্দ	ꯍꯦꯟꯗ
হেন্দবা	ꯍꯦꯟꯗꯕꯥ
হেন্দলুম	ꯍꯦꯟꯗꯂꯨꯝ
হেন্দলুমস	ꯍꯦꯟꯗꯂꯨꯝꯁ
হেন্দিমেন	ꯍꯦꯟꯗꯤꯃꯦꯟ
হেন্দুনা	ꯍꯦꯟꯗꯨꯅꯥ
হেন্ন	ꯍꯦꯟꯅ
হেন্নসু	ꯍꯦꯟꯅꯁꯨ
হেন্না	ꯍꯦꯟꯅꯥ
হেপ্তুলা	ꯍꯦꯞꯇꯨꯂꯥ
হেপ্তুলানা	ꯍꯦꯞꯇꯨꯂꯥꯅꯥ
হেব	ꯍꯦꯕ
হেভি	ꯍꯦꯚꯤ
হেমন্ত	ꯍꯦꯃꯟꯇ
হেমন্তগী	ꯍꯦꯃꯟꯇꯒꯤ
হেমন্তনা	ꯍꯦꯃꯟꯇꯅꯥ
হেমন্তা	ꯍꯦꯃꯟꯇꯥ
হেমাবতিনা	ꯍꯦꯃꯥꯕꯇꯤꯅꯥ
হেরা	ꯍꯦꯔꯥ
হেরাও	ꯍꯦꯔꯥꯑꯣ
হেরিটেজ	ꯍꯦꯔꯤꯇꯦꯖ
হেলথ	ꯍꯦꯜꯊ
হেলপ	ꯍꯦꯂꯞ
হেলমেট	ꯍꯦꯜꯃꯦꯇ
হেল্প	ꯍꯦꯜꯄ
হেল্পর	ꯍꯦꯜꯄꯔ
হেল্পলাইন	ꯍꯦꯜꯄꯂꯥꯏꯟ
হেল্লকপদগী	ꯍꯦꯜꯂꯛꯄꯗꯒꯤ
হেল্লকপা	ꯍꯦꯜꯂꯛꯄꯥ
হেল্লক্লি	ꯍꯦꯜꯂꯛꯂꯤ
হেল্লক্লে	ꯍꯦꯜꯂꯛꯂꯦ
হেল্লগনি	ꯍꯦꯜꯂꯒꯅꯤ
হেল্লবনি	ꯍꯦꯜꯂꯕꯅꯤ
হেল্লবা	ꯍꯦꯜꯂꯕꯥ
হেল্লি	ꯍꯦꯜꯂꯤ
হেল্লে	ꯍꯦꯜꯂꯦ
হৈ	ꯍꯩ
হৈকৎ	ꯍꯩꯀꯠ
হৈগী	ꯍꯩꯒꯤ
হৈঙাং	ꯍꯩꯉꯥꯡ
হৈঙাংদা	ꯍꯩꯉꯥꯡꯗꯥ
হৈঙান	ꯍꯩꯉꯥꯅ
হৈজবা	ꯍꯩꯖꯕꯥ
হৈজাং	ꯍꯩꯖꯥꯪ
হৈজানবগী	ꯍꯩꯖꯥꯅꯕꯒꯤ
হৈজানবা	ꯍꯩꯖꯥꯅꯕꯥ
হৈতনা	ꯍꯩꯇꯅꯥ
হৈতবা	ꯍꯩꯇꯕꯥ
হৈতুপ	ꯍꯩꯇꯨꯞ
হৈথা	ꯍꯩꯊꯥ
হৈদি	ꯍꯩꯗꯤ
হৈনখি	ꯍꯩꯅꯈꯤ
হৈননবা	ꯍꯩꯅꯟꯕꯥ
হৈনবা	ꯍꯩꯅꯕꯥ
হৈনবি	ꯍꯩꯅꯕꯤ
হৈনবী	ꯍꯩꯅꯕꯤ
হৈনবীনা	ꯍꯩꯅꯕꯤꯅꯥ
হৈনিংনা	ꯍꯩꯅꯤꯡꯅꯥ
হৈবগী	ꯍꯩꯕꯒꯤ
হৈবদি	ꯍꯩꯕꯗꯤ
হৈবা	ꯍꯩꯕꯥ
হৈবী	ꯍꯩꯕꯤ
হৈরগা	ꯍꯩꯔꯒꯥ
হৈরবনি	ꯍꯩꯔꯕꯅꯤ
হৈরবশিংনা	ꯍꯩꯔꯕꯁꯤꯡꯅꯥ
হৈরবা	ꯍꯩꯔꯕꯥ
হৈরে	ꯍꯩꯔꯦ
হৈশিংনা	ꯍꯩꯁꯤꯡꯅꯥ
হৈশিংবা	ꯍꯩꯁꯤꯡꯕꯥ
হৈশিংলবা	ꯍꯩꯁꯤꯡꯂꯕꯥ
হৈস্নাম	ꯍꯩꯁꯅꯥꯝ
হয়না	ꯍꯌꯅꯥ
হয়ার	ꯍꯌꯥꯔ
হয়েং	ꯍꯌꯦꯡ
হয়েংগী	ꯍꯌꯦꯡꯒꯤ
হয়েংদগী	ꯍꯌꯦꯡꯗꯒꯤ
হয়েংদি	ꯍꯌꯦꯡꯗꯤ
হয়েংনা	ꯍꯌꯦꯡꯅꯥ
হয়েংসু	ꯍꯌꯦꯡꯁꯨ
হৱাই	ꯍꯋꯥꯏ
হৱাইবম	ꯍꯋꯥꯏꯕꯝ
হৱালা	ꯍꯋꯥꯂꯥ
া	ꯥ
ী	ꯤ
ু	ꯨ
্র	ꯔ
ৎ	ꯠ
য়ং	ꯌꯪ
য়া	ꯌꯥ
য়াংনা	ꯌꯥꯡꯅꯥ
য়াংবা	ꯌꯥꯡꯕꯥ
য়াংলেন	ꯌꯥꯡꯂꯦꯟ
য়াংশিনবা	ꯌꯥꯡꯁꯤꯟꯕꯥ
য়াংশিন্নবা	ꯌꯥꯡꯁꯤꯟꯅꯕꯥ
য়াই	ꯌꯥꯏ
য়াইঙং	ꯌꯥꯏꯉꯪ
য়াইন	ꯌꯥꯏꯟ
য়াইফ	ꯌꯥꯏꯐ
য়াইফনবগী	ꯌꯥꯏꯐꯅꯕꯒꯤ
য়াইফনবগীদমক	ꯌꯥꯏꯐꯅꯕꯒꯤꯗꯃꯛ
য়াইফনবনি	ꯌꯥꯏꯐꯅꯕꯅꯤ
য়াইফনবা	ꯌꯥꯏꯐꯅꯕꯥ
য়াইফনা	ꯌꯥꯏꯐꯅꯥ
য়াইফবগী	ꯌꯥꯏꯐꯕꯒꯤ
য়াইফবা	ꯌꯥꯏꯐꯕꯥ
য়াইফা	ꯌꯥꯏꯐꯥ
য়াইমা	ꯌꯥꯏꯃꯥ
য়াইস্কুল	ꯌꯥꯏꯁ꯭ꯀꯨꯜ
য়াইস্কুলগী	ꯌꯥꯏꯁ꯭ꯀꯨꯜꯒꯤ
য়াইস্কুলদা	ꯌꯥꯏꯁ꯭ꯀꯨꯜꯗꯥ
য়াওং	ꯌꯥꯑꯣꯪ
য়াওই	ꯌꯥꯑꯣꯏ
য়াওখি	ꯌꯥꯑꯣꯈꯤ
য়াওখিদে	ꯌꯥꯑꯣꯈꯤꯗꯦ
য়াওখিবদা	ꯌꯥꯑꯣꯈꯤꯕꯗꯥ
য়াওখিবনি	ꯌꯥꯑꯣꯈꯤꯕꯅꯤ
য়াওখিবশিং	ꯌꯥꯑꯣꯈꯤꯕꯁꯤꯡ
য়াওখিবা	ꯌꯥꯑꯣꯈꯤꯕꯥ
য়াওখ্রে	ꯌꯥꯑꯣꯈ꯭ꯔꯦ
য়াওগদবনি	ꯌꯥꯑꯣꯒꯗꯕꯅꯤ
য়াওগদবা	ꯌꯥꯑꯣꯒꯗꯕꯥ
য়াওগনি	ꯌꯥꯑꯣꯒꯅꯤ
য়াওগে	ꯌꯥꯑꯣꯒꯦ
য়াওজবা	ꯌꯥꯑꯣꯖꯕꯥ
য়াওদনদি	ꯌꯥꯑꯣꯗꯅꯗꯤ
য়াওদনা	ꯌꯥꯑꯣꯗꯅꯥ
য়াওদবনা	ꯌꯥꯑꯣꯗꯕꯅꯥ
য়াওদবনি	ꯌꯥꯑꯣꯗꯕꯅꯤ
য়াওদবা	ꯌꯥꯑꯣꯗꯕꯥ
য়াওদা	ꯌꯥꯑꯣꯗꯥ
য়াওদুনা	ꯌꯥꯑꯣꯗꯨꯅꯥ
য়াওদে	ꯌꯥꯑꯣꯗꯦ
য়াওদ্রবদি	ꯌꯥꯑꯣꯗ꯭ꯔꯕꯗꯤ
য়াওদ্রবসু	ꯌꯥꯑꯣꯗ꯭ꯔꯕꯁꯨ
য়াওদ্রবা	ꯌꯥꯑꯣꯗ꯭ꯔꯕꯥ
য়াওদ্রি	ꯌꯥꯑꯣꯗ꯭ꯔꯤ
য়াওদ্রিবা	ꯌꯥꯑꯣꯗ꯭ꯔꯤꯕꯥ
য়াওদ্রে	ꯌꯥꯑꯣꯗ꯭ꯔꯦ
য়াওননবগী	ꯌꯥꯑꯣꯟꯅꯕꯒꯤ
য়াওননবা	ꯌꯥꯑꯣꯟꯅꯕꯥ
য়াওনবসু	ꯌꯥꯑꯣꯟꯕꯁꯨ
য়াওনবা	ꯌꯥꯑꯣꯟꯕꯥ
য়াওনা	ꯌꯥꯑꯣꯅꯥ
য়াওনিংবা	ꯌꯥꯑꯣꯅꯤꯡꯕꯥ
য়াওবগী	ꯌꯥꯑꯣꯕꯒꯤ
য়াওবদগী	ꯌꯥꯑꯣꯕꯗꯒꯤ
য়াওবদা	ꯌꯥꯑꯣꯕꯗꯥ
য়াওবনি	ꯌꯥꯑꯣꯕꯅꯤ
য়াওবশিং	ꯌꯥꯑꯣꯕꯁꯤꯡ
য়াওবা	ꯌꯥꯑꯣꯕꯥ
য়াওবিয়ু	ꯌꯥꯑꯣꯕꯤꯌꯨ
য়াওবীয়ু	ꯌꯥꯑꯣꯕꯤꯌꯨ
য়াওব্রা	ꯌꯥꯑꯣꯕ꯭ꯔꯥ
য়াওরকখি	ꯌꯥꯑꯣꯔꯛꯈꯤ
য়াওরকখিগনি	ꯌꯥꯑꯣꯔꯛꯈꯤꯒꯅꯤ
য়াওরকপদা	ꯌꯥꯑꯣꯔꯛꯄꯗꯥ
য়াওরকপনি	ꯌꯥꯑꯣꯔꯛꯄꯅꯤ
য়াওরকপা	ꯌꯥꯑꯣꯔꯛꯄꯥ
য়াওরক্কনি	ꯌꯥꯑꯣꯔꯛꯀꯅꯤ
য়াওরক্লবনি	ꯌꯥꯑꯣꯔꯛꯂꯕꯅꯤ
য়াওরক্লি	ꯌꯥꯑꯣꯔꯛꯂꯤ
য়াওরক্লিবা	ꯌꯥꯑꯣꯔꯛꯂꯤꯕꯥ
য়াওরক্লে	ꯌꯥꯑꯣꯔꯛꯂꯦ
য়াওরগনি	ꯌꯥꯑꯣꯔꯒꯅꯤ
য়াওরগা	ꯌꯥꯑꯣꯔꯒꯥ
য়াওরনবা	ꯌꯥꯑꯣꯔꯅꯕꯥ
য়াওরবদি	ꯌꯥꯑꯣꯔꯕꯗꯤ
য়াওরবনি	ꯌꯥꯑꯣꯔꯕꯅꯤ
য়াওরবসু	ꯌꯥꯑꯣꯔꯕꯁꯨ
য়াওরবা	ꯌꯥꯑꯣꯔꯕꯥ
য়াওরমদবা	ꯌꯥꯑꯣꯔꯝꯗꯕꯥ
য়াওরমদে	ꯌꯥꯑꯣꯔꯝꯗꯦ
য়াওরমদ্রবদি	ꯌꯥꯑꯣꯔꯝꯗ꯭ꯔꯕꯗꯤ
য়াওরম্বদু	ꯌꯥꯑꯣꯔꯝꯕꯗꯨ
য়াওরম্বা	ꯌꯥꯑꯣꯔꯝꯕꯥ
য়াওরম্মী	ꯌꯥꯑꯣꯔꯝꯃꯤ
য়াওরম্লবদি	ꯌꯥꯑꯣꯔꯝꯂꯕꯗꯤ
য়াওরি	ꯌꯥꯑꯣꯔꯤ
য়াওরিবগে	ꯌꯥꯑꯣꯔꯤꯕꯒꯦ
য়াওরিবা	ꯌꯥꯑꯣꯔꯤꯕꯥ
য়াওরুবশিং	ꯌꯥꯑꯣꯔꯨꯕꯁꯤꯡ
য়াওরুবা	ꯌꯥꯑꯣꯔꯨꯕꯥ
য়াওরে	ꯌꯥꯑꯣꯔꯦ
য়াওল	ꯌꯥꯑꯣꯜ
য়াওশং	ꯌꯥꯑꯣꯁꯪ
য়াওশংগী	ꯌꯥꯑꯣꯁꯪꯒꯤ
য়াওশঙ	ꯌꯥꯑꯣꯁꯡ
য়াওশিনবা	ꯌꯥꯑꯣꯁꯤꯟꯕꯥ
য়াওশিন্দুনা	ꯌꯥꯑꯣꯁꯤꯟꯗꯨꯅꯥ
য়াওশিল্লকপগী	ꯌꯥꯑꯣꯁꯤꯜꯂꯛꯄꯒꯤ
য়াওশিল্লকপা	ꯌꯥꯑꯣꯁꯤꯜꯂꯛꯄꯥ
য়াওহনখি	ꯌꯥꯑꯣꯍꯟꯈꯤ
য়াওহনগদবনি	ꯌꯥꯑꯣꯍꯟꯒꯗꯕꯅꯤ
য়াওহনগনি	ꯌꯥꯑꯣꯍꯟꯒꯅꯤ
য়াওহনবা	ꯌꯥꯑꯣꯍꯟꯕꯥ
য়াওহন্দনা	ꯌꯥꯑꯣꯍꯟꯗꯅꯥ
য়াওহন্দুনা	ꯌꯥꯑꯣꯍꯟꯗꯨꯅꯥ
য়াওহন্নবা	ꯌꯥꯑꯣꯍꯟꯅꯕꯥ
য়াকা	ꯌꯥꯀꯥ
য়াখি	ꯌꯥꯈꯤ
য়াখিদে	ꯌꯥꯈꯤꯗꯦ
য়াখিদ্রে	ꯌꯥꯈꯤꯗ꯭ꯔꯦ
য়াখিবনি	ꯌꯥꯈꯤꯕꯅꯤ
য়াখিবশিংনা	ꯌꯥꯈꯤꯕꯁꯤꯡꯅꯥ
য়াখিবা	ꯌꯥꯈꯤꯕꯥ
য়াখিবী	ꯌꯥꯈꯤꯕꯤ
য়াখ্রে	ꯌꯥꯈ꯭ꯔꯦ
য়াগদগে	ꯌꯥꯒꯗꯒꯦ
য়াগদবনি	ꯌꯥꯒꯗꯕꯅꯤ
য়াগদবা	ꯌꯥꯒꯗꯕꯥ
য়াগদ্রা	ꯌꯥꯒꯗ꯭ꯔꯥ
য়াগনি	ꯌꯥꯒꯅꯤ
য়াঙ্খৈ	ꯌꯥꯡꯈꯩ
য়াঙ্খৈমঙা	ꯌꯥꯡꯈꯩꯃꯉꯥ
য়াজখ্রে	ꯌꯥꯖꯈ꯭ꯔꯦ
য়াজরে	ꯌꯥꯖꯔꯦ
য়াজৈ	ꯌꯥꯖꯩ
য়াথং	ꯌꯥꯊꯪ
য়াদদুনা	ꯌꯥꯗꯗꯨꯅꯥ
য়াদনবা	ꯌꯥꯗꯅꯕꯥ
য়াদনা	ꯌꯥꯗꯅꯥ
য়াদব	ꯌꯥꯗꯕ
য়াদবগী	ꯌꯥꯗꯕꯒꯤ
য়াদবদগী	ꯌꯥꯗꯕꯗꯒꯤ
য়াদবনা	ꯌꯥꯗꯕꯅꯥ
য়াদবনিনা	ꯌꯥꯗꯕꯅꯤꯅꯥ
য়াদবমখৈ	ꯌꯥꯗꯕꯝꯈꯩ
য়াদবা	ꯌꯥꯗꯕꯥ
য়াদুনা	ꯌꯥꯗꯨꯅꯥ
য়াদে	ꯌꯥꯗꯦ
য়াদ্রগা	ꯌꯥꯗꯔ꯭ꯒꯥ
য়াদ্রবদি	ꯌꯥꯗ꯭ꯔꯕꯗꯤ
য়াদ্রবনি	ꯌꯥꯗꯔ꯭ꯕꯅꯤ
য়াদ্রবা	ꯌꯥꯗ꯭ꯔꯕꯥ
য়াদ্রি	ꯌꯥꯗ꯭ꯔꯤ
য়াদ্রিঙৈ	ꯌꯥꯗ꯭ꯔꯤꯉꯩ
য়াদ্রে	ꯌꯥꯗ꯭ꯔꯦ
য়ান	ꯌꯥꯟ
য়ানখি	ꯌꯥꯅꯈꯤ
য়ানখিবা	ꯌꯥꯅꯈꯤꯕꯥ
য়ানখ্রে	ꯌꯥꯅꯈ꯭ꯔꯦ
য়াননবগী	ꯌꯥꯟꯅꯕꯒꯤ
য়াননবা	ꯌꯥꯟꯅꯕꯥ
য়ানবগী	ꯌꯥꯟꯕꯒꯤ
য়ানবনি	ꯌꯥꯟꯕꯅꯤ
য়ানবসু	ꯌꯥꯟꯕꯁꯨ
য়ানবা	ꯌꯥꯅꯕꯥ
য়ানরদুনা	ꯌꯥꯅꯔꯗꯨꯅꯥ
য়ানরবা	ꯌꯥꯅꯔꯕꯥ
য়ানরে	ꯌꯥꯅꯔꯦ
য়ানশিন্নরগা	ꯌꯥꯟꯁꯤꯟꯅꯔꯒꯥ
য়ানা	ꯌꯥꯅꯥ
য়ানি	ꯌꯥꯅꯤ
য়ানিংদবা	ꯌꯥꯅꯤꯡꯗꯕꯥ
য়ানিংদে	ꯌꯥꯅꯤꯡꯗꯦ
য়ানিংনা	ꯌꯥꯅꯤꯡꯅꯥ
য়ানিংবা	ꯌꯥꯅꯤꯡꯕꯥ
য়ানীং	ꯌꯥꯅꯤꯪ
য়ানীংদনা	ꯌꯥꯅꯤꯪꯗꯅꯥ
য়ান্থরগা	ꯌꯥꯟꯊꯔꯒꯥ
য়ান্থৎপগী	ꯌꯥꯟꯊꯠꯄꯒꯤ
য়ান্থৎপা	ꯌꯥꯟꯊꯠꯄꯥ
য়ান্দুনা	ꯌꯥꯟꯗꯨꯅꯥ
য়ান্নদুনা	ꯌꯥꯟꯅꯗꯨꯅꯥ
য়ান্ননা	ꯌꯥꯟꯅꯅꯥ
য়ান্নবা	ꯌꯥꯟꯅꯕꯥ
য়ান্নরে	ꯌꯥꯟꯅꯔꯦ
য়াফম	ꯌꯥꯐꯝ
য়াবগা	ꯌꯥꯕꯒꯥ
য়াবগী	ꯌꯥꯕꯒꯤ
য়াবগীদমক	ꯌꯥꯕꯒꯤꯗꯃꯛ
য়াবগে	ꯌꯥꯕꯒꯦ
য়াবদগী	ꯌꯥꯕꯗꯒꯤ
য়াবদা	ꯌꯥꯕꯗꯥ
য়াবদি	ꯌꯥꯕꯗꯤ
য়াবনা	ꯌꯥꯕꯅꯥ
য়াবনি	ꯌꯥꯕꯅꯤ
য়াবমখৈ	ꯌꯥꯕꯝꯈꯩ
য়াবশিং	ꯌꯥꯕꯁꯤꯡ
য়াবশিংগী	ꯌꯥꯕꯁꯤꯡꯒꯤ
য়াবা	ꯌꯥꯕꯥ
য়াবিরদুনা	ꯌꯥꯕꯤꯔꯗꯨꯅꯥ
য়াবিয়ু	ꯌꯥꯕꯤꯌꯨ
য়াবীয়ু	ꯌꯥꯕꯤꯌꯨ
য়াব্রা	ꯌꯥꯕ꯭ꯔꯥ
য়ামখিদে	ꯌꯥꯝꯈꯤꯗꯦ
য়ামখ্রবা	ꯌꯥꯝꯈ꯭ꯔꯕꯥ
য়ামখৎলক্লি	ꯌꯥꯝꯈꯠꯂꯛꯂꯤ
য়ামজদবা	ꯌꯥꯝꯖꯗꯕꯥ
য়ামদনা	ꯌꯥꯝꯗꯅꯥ
য়ামদবা	ꯌꯥꯝꯗꯕꯥ
য়ামদ্রবদা	ꯌꯥꯝꯗ꯭ꯔꯕꯗꯥ
য়ামদ্রবা	ꯌꯥꯃꯗ꯭ꯔꯕꯥ
য়ামনা	ꯌꯥꯝꯅꯥ
য়ামিন্নদুনা	ꯌꯥꯃꯤꯟꯅꯗꯨꯅꯥ
য়ামিন্নবা	ꯌꯥꯃꯤꯟꯅꯕꯥ
য়াম্ন	ꯌꯥꯝꯅ
য়াম্নদি	ꯌꯥꯝꯅꯗꯤ
য়াম্নমক	ꯌꯥꯝꯅꯃꯛ
য়াম্নসু	ꯌꯥꯝꯅꯁꯨ
য়াম্না	ꯌꯥꯝꯅꯥ
য়াম্বদা	ꯌꯥꯝꯕꯗꯥ
য়াম্বা	ꯌꯥꯝꯕꯥ
য়াম্বী	ꯌꯥꯝꯕꯤ
য়াম্বেম	ꯌꯥꯝꯕꯦꯝ
য়াম্মি	ꯌꯥꯝꯃꯤ
য়াম্মী	ꯌꯥꯝꯃꯤ
য়াম্লবদা	ꯌꯥꯝꯂꯕꯗꯥ
য়াম্লবদি	ꯌꯥꯝꯂꯕꯗꯤ
য়াম্লবা	ꯌꯥꯝꯂꯕꯥ
য়াম্লিবা	ꯌꯥꯝꯂꯤꯕꯥ
য়াম্লে	ꯌꯥꯝꯂꯦ
য়ার	ꯌꯥꯔ
য়ারকপনি	ꯌꯥꯔꯛꯄꯅꯤ
য়ারকপা	ꯌꯥꯔꯛꯄꯥ
য়ারক্লি	ꯌꯥꯔꯛꯂꯤ
য়ারগনি	ꯌꯥꯔꯒꯅꯤ
য়ারগা	ꯌꯥꯔꯒꯥ
য়ারদুনা	ꯌꯥꯔꯗꯨꯅꯥ
য়ারবদি	ꯌꯥꯔꯕꯗꯤ
য়ারবা	ꯌꯥꯔꯕꯥ
য়ারম্বা	ꯌꯥꯔꯝꯕꯥ
য়ারম্মী	ꯌꯥꯔꯝꯃꯤ
য়ারি	ꯌꯥꯔꯤ
য়ারিবমখৈ	ꯌꯥꯔꯤꯕꯝꯈꯩ
য়ারিবশিংনা	ꯌꯥꯔꯤꯕꯁꯤꯡꯅꯥ
য়ারিবা	ꯌꯥꯔꯤꯕꯥ
য়ারুবা	ꯌꯥꯔꯨꯕꯥ
য়ারে	ꯌꯥꯔꯦ
য়ার্দ	ꯌꯥꯔꯗ
য়াল্লগা	ꯌꯥꯜꯂꯒꯥ
য়াস	ꯌꯥꯁ
য়াসনা	ꯌꯥꯁꯅꯥ
য়াহনখিদে	ꯌꯥꯍꯟꯈꯤꯗꯦ
য়াহনখ্রে	ꯌꯥꯍꯟꯈ꯭ꯔꯦ
য়াহনদবা	ꯌꯥꯍꯟꯗꯕꯥ
য়াহনদ্রে	ꯌꯥꯍꯟꯗ꯭ꯔꯦ
য়াহনবগী	ꯌꯥꯍꯟꯕꯒꯤ
য়াহনবা	ꯌꯥꯍꯟꯕꯥ
য়াহন্দুনা	ꯌꯥꯍꯟꯗꯨꯅꯥ
য়াহন্নবসু	ꯌꯥꯍꯟꯅꯕꯁꯨ
য়াহন্নবা	ꯌꯥꯍꯟꯅꯕꯥ
য়াহল্লগনি	ꯌꯥꯍꯜꯂꯒꯅꯤ
য়াহল্লি	ꯌꯥꯍꯜꯂꯤ
য়াহল্লিবা	ꯌꯥꯍꯜꯂꯤꯕꯥ
য়াৎপা	ꯌꯥꯠꯄꯥ
য়ু	ꯌꯨ
য়ুংগদবা	ꯌꯨꯡꯒꯗꯕꯥ
য়ুংদুনা	ꯌꯨꯡꯗꯨꯅꯥ
য়ুংনা	ꯌꯨꯪꯅꯥ
য়ুংবা	ꯌꯨꯡꯕꯥ
য়ুএসতা	ꯌꯨꯑꯦꯁꯇꯥ
য়ুগী	ꯌꯨꯒꯤ
য়ুজ	ꯌꯨꯖ
য়ুথক	ꯌꯨꯊꯛ
য়ুনচিংবা	ꯌꯨꯅꯆꯤꯡꯕꯥ
য়ুনাইটেদ	ꯌꯨꯅꯥꯏꯇꯦꯗ
য়ুনাইটেদকী	ꯌꯨꯅꯥꯏꯇꯦꯗꯀꯤ
য়ুনাইটেদনা	ꯌꯨꯅꯥꯏꯇꯦꯗꯅꯥ
য়ুনিক	ꯌꯨꯅꯤꯛ
য়ুনিট	ꯌꯨꯅꯤꯠ
য়ুনিটকী	ꯌꯨꯅꯤꯠꯀꯤ
য়ুনিটতা	ꯌꯨꯅꯤꯠꯇꯥ
য়ুনিটনসু	ꯌꯨꯅꯤꯠꯅꯁꯨ
য়ুনিটনা	ꯌꯨꯅꯤꯠꯅꯥ
য়ুনিটশিং	ꯌꯨꯅꯤꯠꯁꯤꯡ
য়ুনিভর্সেল	ꯌꯨꯅꯤꯚꯔꯁꯦꯜ
য়ুনিসেফকী	ꯌꯨꯅꯤꯁꯦꯐꯀꯤ
য়ুনিয়ন	ꯌꯨꯅꯤꯌꯟ
য়ুনিয়নগা	ꯌꯨꯅꯤꯌꯟꯒꯥ
য়ুনিয়নগী	ꯌꯨꯅꯤꯌꯟꯒꯤ
য়ুনিয়ননা	ꯌꯨꯅꯤꯌꯟꯅꯥ
য়ুনিয়ন্না	ꯌꯨꯅꯤꯌꯟꯅꯥ
য়ুবা	ꯌꯨꯕꯥ
য়ুবি	ꯌꯨꯕꯤ
য়ুম	ꯌꯨꯝ
য়ুমগী	ꯌꯨꯝꯒꯤ
য়ুমথংনবা	ꯌꯨꯝꯊꯪꯅꯕꯥ
য়ুমথংনরিবা	ꯌꯨꯝꯊꯪꯅꯔꯤꯕꯥ
য়ুমদগী	ꯌꯨꯝꯗꯒꯤ
য়ুমদসু	ꯌꯨꯝꯗꯁꯨ
য়ুমদা	ꯌꯨꯝꯗꯥ
য়ুমশকৈশ	ꯌꯨꯝꯁꯀꯩꯁ
য়ুমশকৈশা	ꯌꯨꯝꯁꯀꯩꯁꯥ
য়ুমশিং	ꯌꯨꯝꯁꯤꯡ
য়ুমশিংদা	ꯌꯨꯝꯁꯤꯡꯗꯥ
য়ুম্নাম	ꯌꯨꯝꯅꯥꯝ
য়ুম্নামনা	ꯌꯨꯝꯅꯥꯝꯅꯥ
য়ুম্ফম	ꯌꯨꯝꯐꯝ
য়ুম্বান	ꯌꯨꯝꯕꯥꯟ
য়ুম্বাল	ꯌꯨꯝꯕꯥꯜ
য়ুম্বী	ꯌꯨꯝꯕꯤ
য়ুম্বু	ꯌꯨꯝꯕꯨ
য়ুম্লেম্বম	ꯌꯨꯝꯂꯦꯝꯕꯝ
য়ুরেম্বম	ꯌꯨꯔꯦꯝꯕꯝ
য়ুরেম্বমদগী	ꯌꯨꯔꯦꯝꯕꯝꯗꯒꯤ
য়ুহান	ꯌꯨꯍꯥꯟ
য়ূম	ꯌꯨꯃ
য়ূম্বী	ꯌꯨꯝꯕꯤ
য়েং	ꯌꯦꯪ
য়েংই	ꯌꯦꯡꯏ
য়েংখি	ꯌꯦꯡꯈꯤ
য়েংখিনি	ꯌꯦꯪꯈꯤꯅꯤ
য়েংখ্রে	ꯌꯦꯡꯈ꯭ꯔꯦ
য়েংগদবনি	ꯌꯦꯡꯒꯗꯕꯅꯤ
য়েংগনি	ꯌꯦꯡꯒꯅꯤ
য়েংঙি	ꯌꯦꯪꯉꯤ
য়েংঙু	ꯌꯦꯪꯉꯨ
য়েংজবা	ꯌꯦꯡꯖꯕꯥ
য়েংথিনবগী	ꯌꯦꯡꯊꯤꯅꯕꯒꯤ
য়েংথিনবা	ꯌꯦꯡꯊꯤꯅꯕꯥ
য়েংদনা	ꯌꯦꯡꯗꯅꯥ
য়েংদুনা	ꯌꯦꯡꯗꯨꯅꯥ
য়েংদে	ꯌꯦꯪꯗꯦ
য়েংনখ্রে	ꯌꯦꯪꯅꯈꯔꯦ
য়েংনদুনা	ꯌꯦꯪꯅꯗꯨꯅꯥ
য়েংনবগী	ꯌꯦꯡꯅꯕꯒꯤ
য়েংনবদা	ꯌꯦꯡꯅꯕꯗꯥ
য়েংনবা	ꯌꯦꯡꯅꯕꯥ
য়েংনরি	ꯌꯦꯡꯅꯔꯤ
য়েংনরুবদা	ꯌꯦꯡꯅꯔꯨꯕꯗꯥ
য়েংনরুরবদি	ꯌꯦꯡꯅꯔꯨꯔꯕꯗꯤ
য়েংনরে	ꯌꯦꯪꯅꯔꯦ
য়েংনিংবা	ꯌꯦꯡꯅꯤꯡꯕꯥ
য়েংনীংবনা	ꯌꯦꯪꯅꯤꯪꯕꯅꯥ
য়েংনৈ	ꯌꯦꯪꯅꯩ
য়েংবগী	ꯌꯦꯡꯕꯒꯤ
য়েংবদদি	ꯌꯦꯪꯕꯗꯗꯤ
য়েংবদসু	ꯌꯦꯡꯕꯗꯁꯨ
য়েংবদা	ꯌꯦꯡꯕꯗꯥ
য়েংবা	ꯌꯦꯡꯕꯥ
য়েংবিয়ু	ꯌꯦꯪꯕꯤꯌꯨ
য়েংমিন্নবা	ꯌꯦꯡꯃꯤꯟꯅꯕꯥ
য়েংলগা	ꯌꯦꯡꯂꯒꯥ
য়েংলদুনা	ꯌꯦꯪꯂꯗꯨꯅꯥ
য়েংলবদি	ꯌꯦꯡꯂꯕꯗꯤ
য়েংলবা	ꯌꯦꯡꯂꯕꯥ
য়েংলম্লগা	ꯌꯦꯪꯂꯝꯂꯒꯥ
য়েংলসি	ꯌꯦꯪꯂꯁꯤ
য়েংলি	ꯌꯦꯡꯂꯤ
য়েংলিঙৈদা	ꯌꯦꯪꯂꯤꯉꯩꯗꯥ
য়েংলিবা	ꯌꯦꯡꯂꯤꯕꯥ
য়েংলুই	ꯌꯦꯪꯂꯨꯏ
য়েংলুবদা	ꯌꯦꯡꯂꯨꯕꯗꯥ
য়েংলুরগদি	ꯌꯦꯡꯂꯨꯔꯒꯗꯤ
য়েংশি	ꯌꯦꯡꯁꯤ
য়েংশিন	ꯌꯦꯡꯁꯤꯟ
য়েংশিনখি	ꯌꯦꯡꯁꯤꯟꯈꯤ
য়েংশিনখিবনি	ꯌꯦꯡꯁꯤꯟꯈꯤꯕꯅꯤ
য়েংশিনখ্রবনি	ꯌꯦꯡꯁꯤꯟꯈ꯭ꯔꯕꯅꯤ
য়েংশিনখ্রে	ꯌꯦꯡꯁꯤꯟꯈ꯭ꯔꯦ
য়েংশিনগদবনি	ꯌꯦꯡꯁꯤꯟꯒꯗꯕꯅꯤ
য়েংশিনগনি	ꯌꯦꯡꯁꯤꯟꯒꯅꯤ
য়েংশিনফম	ꯌꯦꯡꯁꯤꯟꯐꯝ
য়েংশিনবগা	ꯌꯦꯡꯁꯤꯟꯕꯒꯥ
য়েংশিনবগী	ꯌꯦꯡꯁꯤꯟꯕꯒꯤ
য়েংশিনবদা	ꯌꯦꯡꯁꯤꯟꯕꯗꯥ
য়েংশিনবা	ꯌꯦꯡꯁꯤꯟꯕꯥ
য়েংশিনবীদুনা	ꯌꯦꯡꯁꯤꯟꯕꯤꯗꯨꯅꯥ
য়েংশিন্নবা	ꯌꯦꯡꯁꯤꯟꯅꯕꯥ
য়েংশিল্লগনি	ꯌꯦꯡꯁꯤꯜꯂꯒꯅꯤ
য়েংশিল্লগা	ꯌꯦꯡꯁꯤꯜꯂꯒꯥ
য়েংশিল্লবা	ꯌꯦꯡꯁꯤꯜꯂꯕꯥ
য়েংশিল্লি	ꯌꯦꯡꯁꯤꯜꯂꯤ
য়েংশিল্লিবা	ꯌꯦꯡꯁꯤꯜꯂꯤꯕꯥ
য়েংশিল্লে	ꯌꯦꯡꯁꯤꯜꯂꯦ
য়েংসি	ꯌꯦꯪꯁꯤ
য়েংহন্নবা	ꯌꯦꯡꯍꯟꯅꯕꯥ
য়েকপগী	ꯌꯦꯛꯄꯒꯤ
য়েকপা	ꯌꯦꯛꯄꯥ
য়েক্নবগী	ꯌꯦꯛꯅꯕꯒꯤ
য়েক্নবনা	ꯌꯦꯛꯅꯕꯅꯥ
য়েক্নবনি	ꯌꯦꯛꯅꯕꯅꯤ
য়েক্নববু	ꯌꯦꯛꯅꯕꯕꯨ
য়েক্নবা	ꯌꯦꯛꯅꯕꯥ
য়েতুম	ꯌꯦꯇꯨꯝ
য়েন	ꯌꯦꯟ
য়েনখা	ꯌꯦꯟꯈꯥ
য়েনখাদা	ꯌꯦꯟꯈꯥꯗꯥ
য়েনদা	ꯌꯦꯟꯗꯥ
য়েনবগী	ꯌꯦꯟꯕꯒꯤ
য়েনবা	ꯌꯦꯟꯕꯥ
য়েনিং	ꯌꯦꯅꯤꯡ
য়েন্দ্রেনবম	ꯌꯦꯟꯗ꯭ꯔꯦꯟꯕꯝ
য়েন্নদুনা	ꯌꯦꯟꯅꯗꯨꯅꯥ
য়েন্নবগী	ꯌꯦꯟꯅꯕꯒꯤ
য়েন্নবা	ꯌꯦꯟꯅꯕꯥ
য়েরুম	ꯌꯦꯔꯨꯝ
য়েস	ꯌꯦꯁ
য়েৎ	ꯌꯦꯠ
য়েৎকী	ꯌꯦꯠꯀꯤ
য়েৎতা	ꯌꯦꯠꯇꯥ
য়েৎনদুনা	ꯌꯦꯠꯅꯗꯨꯅꯥ
য়েৎনবা	ꯌꯦꯠꯅꯕꯥ
য়েৎনরিবা	ꯌꯦꯠꯅꯔꯤꯕꯥ
য়ৈদুনা	ꯌꯩꯗꯨꯅꯥ
য়ৈনা	ꯌꯩꯅꯥ
য়ৈবদা	ꯌꯩꯕꯗꯥ
য়ৈরগা	ꯌꯩꯔꯒꯥ
ৱা	ꯋꯥ
ৱাং	ꯋꯥꯪ
ৱাংই	ꯋꯥꯡꯏ
ৱাংখি	ꯋꯥꯡꯈꯤ
ৱাংখেম	ꯋꯥꯡꯈꯦꯝ
ৱাংখৈ	ꯋꯥꯡꯈꯩ
ৱাংখৈদা	ꯋꯥꯡꯈꯩꯗꯥ
ৱাংখৎলকখিবনি	ꯋꯥꯡꯈꯠꯂꯛꯈꯤꯕꯅꯤ
ৱাংখৎলকপা	ꯋꯥꯡꯈꯠꯂꯛꯄꯥ
ৱাংখৎলক্লি	ꯋꯥꯡꯈꯠꯂꯛꯂꯤ
ৱাংখৎলক্লিবনি	ꯋꯥꯡꯈꯠꯂꯛꯂꯤꯕꯅꯤ
ৱাংখৎলক্লিবা	ꯋꯥꯡꯈꯠꯂꯛꯂꯤꯕꯥ
ৱাংখৎহনবা	ꯋꯥꯡꯈꯠꯍꯟꯕꯥ
ৱাংখৎহন্নবা	ꯋꯥꯡꯈꯠꯍꯟꯅꯕꯥ
ৱাংঙু	ꯋꯥꯡꯉꯨ
ৱাংজিং	ꯋꯥꯡꯖꯤꯡ
ৱাংজিংগী	ꯋꯥꯡꯖꯤꯡꯒꯤ
ৱাংজিংদগী	ꯋꯥꯡꯖꯤꯡꯗꯒꯤ
ৱাংজিংদা	ꯋꯥꯡꯖꯤꯡꯗꯥ
ৱাংজিংনা	ꯋꯥꯡꯖꯤꯡꯅꯥ
ৱাংনা	ꯋꯥꯡꯅꯥ
ৱাংবগা	ꯋꯥꯡꯕꯒꯥ
ৱাংবদা	ꯋꯥꯪꯕꯗꯥ
ৱাংবনি	ꯋꯥꯡꯕꯅꯤ
ৱাংবা	ꯋꯥꯡꯕꯥ
ৱাংমদগী	ꯋꯥꯡꯃꯗꯒꯤ
ৱাংমদনি	ꯋꯥꯡꯃꯗꯅꯤ
ৱাংমদসু	ꯋꯥꯡꯃꯗꯁꯨ
ৱাংমদা	ꯋꯥꯡꯃꯗꯥ
ৱাংমা	ꯋꯥꯡꯃꯥ
ৱাংলবনি	ꯋꯥꯡꯂꯕꯅꯤ
ৱাংলম্বা	ꯋꯥꯡꯂꯝꯕꯥ
ৱাংলম্লগনি	ꯋꯥꯡꯂꯝꯂꯒꯅꯤ
ৱাংলি	ꯋꯥꯡꯂꯤ
ৱাংলিবা	ꯋꯥꯡꯂꯤꯕꯥ
ৱাংলে	ꯋꯥꯡꯂꯦ
ৱাংলেন	ꯋꯥꯡꯂꯦꯟ
ৱাই	ꯋꯥꯏ
ৱাইজ	ꯋꯥꯏꯖ
ৱাইনা	ꯋꯥꯏꯅꯥ
ৱাইফুল	ꯋꯥꯏꯐꯨꯜ
ৱাইফৈ	ꯋꯥꯏꯐꯩ
ৱাইফৈনা	ꯋꯥꯏꯐꯩꯅꯥ
ৱাইরম	ꯋꯥꯏꯔꯝ
ৱাইল্ড	ꯋꯥꯏꯜꯗ
ৱাইল্ডলাইফ	ꯋꯥꯏꯜꯗꯂꯥꯏꯐ
ৱাক	ꯋꯥꯛ
ৱাকচিং	ꯋꯥꯛꯆꯤꯡ
ৱাকর	ꯋꯥꯀꯔ
ৱাকিং	ꯋꯥꯀꯤꯡ
ৱাকৎ	ꯋꯥꯀꯠ
ৱাকৎকী	ꯋꯥꯀꯠꯀꯤ
ৱাকৎখি	ꯋꯥꯀꯠꯈꯤ
ৱাকৎখিবনি	ꯋꯥꯀꯠꯈꯤꯕꯅꯤ
ৱাকৎখ্রে	ꯋꯥꯀꯠꯈ꯭ꯔꯦ
ৱাকৎপা	ꯋꯥꯀꯠꯄꯥ
ৱাকৎলকপদগী	ꯋꯥꯀꯠꯂꯛꯄꯗꯒꯤ
ৱাকৎশিং	ꯋꯥꯀꯠꯁꯤꯡ
ৱাখল	ꯋꯥꯈꯜ
ৱাখলগা	ꯋꯥꯈꯜꯒꯥ
ৱাখলগী	ꯋꯥꯈꯜꯒꯤ
ৱাখলদগী	ꯋꯥꯈꯜꯗꯒꯤ
ৱাখলদা	ꯋꯥꯈꯜꯗꯥ
ৱাখলনা	ꯋꯥꯈꯜꯅꯥ
ৱাখলবু	ꯋꯥꯈꯜꯕꯨ
ৱাগদবা	ꯋꯥꯒꯗꯕꯥ
ৱাগা	ꯋꯥꯒꯥ
ৱাগী	ꯋꯥꯒꯤ
ৱাঙম	ꯋꯥꯉꯝ
ৱাঙমদা	ꯋꯥꯉꯝꯗꯥ
ৱাঙাঙ	ꯋꯥꯉꯥꯉ
ৱাঙ্খৈ	ꯋꯥꯡꯈꯩ
ৱাটর	ꯋꯥꯇꯔ
ৱাটরৱেজ	ꯋꯥꯇꯔꯋꯦꯖ
ৱাটসএপ	ꯋꯥꯇꯁꯑꯦꯞ
ৱাতনি	ꯋꯥꯇꯅꯤ
ৱাতা	ꯋꯥꯇꯥ
ৱাতাই	ꯋꯥꯇꯥꯏ
ৱাত্তনা	ꯋꯥꯠꯇꯅꯥ
ৱাদনি	ꯋꯥꯗꯅꯤ
ৱাদি	ꯋꯥꯗꯤ
ৱাদু	ꯋꯥꯗꯨ
ৱান	ꯋꯥꯟ
ৱানখি	ꯋꯥꯟꯈꯤ
ৱানগী	ꯋꯥꯟꯒꯤ
ৱানদা	ꯋꯥꯟꯗꯥ
ৱানবা	ꯋꯥꯟꯕꯥ
ৱানরবা	ꯋꯥꯟꯔꯕꯥ
ৱানরিবা	ꯋꯥꯟꯔꯤꯕꯥ
ৱানা	ꯋꯥꯅꯥ
ৱানি	ꯋꯥꯅꯤ
ৱানিংঙাই	ꯋꯥꯅꯤꯪꯉꯥꯏ
ৱান্থদুনা	ꯋꯥꯟꯊꯗꯨꯅꯥ
ৱাপল	ꯋꯥꯄꯜ
ৱাপাল	ꯋꯥꯄꯥꯜ
ৱাফম	ꯋꯥꯐꯝ
ৱাফমগা	ꯋꯥꯐꯝꯒꯥ
ৱাফমগী	ꯋꯥꯐꯝꯒꯤ
ৱাফমদগী	ꯋꯥꯐꯝꯗꯒꯤ
ৱাফমদা	ꯋꯥꯐꯝꯗꯥ
ৱাফমদি	ꯋꯥꯐꯝꯗꯤ
ৱাফমদু	ꯋꯥꯐꯝꯗꯨ
ৱাফমনচিংবা	ꯋꯥꯐꯝꯅꯆꯤꯡꯕꯥ
ৱাফমনা	ꯋꯥꯐꯝꯅꯥ
ৱাফমনি	ꯋꯥꯐꯝꯅꯤ
ৱাফমশিং	ꯋꯥꯐꯝꯁꯤꯡ
ৱাফমশিংগী	ꯋꯥꯐꯝꯁꯤꯡꯒꯤ
ৱাফমশিংদা	ꯋꯥꯐꯝꯁꯤꯡꯗꯥ
ৱাফমশিংসু	ꯋꯥꯐꯝꯁꯤꯡꯁꯨ
ৱাফমসি	ꯋꯥꯐꯝꯁꯤ
ৱাফমসু	ꯋꯥꯐꯝꯁꯨ
ৱাবগাই	ꯋꯥꯕꯒꯥꯏ
ৱাবনসু	ꯋꯥꯕꯟꯁꯨ
ৱাবনা	ꯋꯥꯕꯅꯥ
ৱাবা	ꯋꯥꯕꯥ
ৱামং	ꯋꯥꯃꯪ
ৱামংদা	ꯋꯥꯃꯪꯗꯥ
ৱার	ꯋꯥꯔ
ৱারগদবা	ꯋꯥꯔꯒꯗꯕꯥ
ৱারগা	ꯋꯥꯔꯒꯥ
ৱারগী	ꯋꯥꯔꯒꯤ
ৱারদা	ꯋꯥꯔꯗꯥ
ৱারবা	ꯋꯥꯔꯕꯥ
ৱারম	ꯋꯥꯔꯝ
ৱারি	ꯋꯥꯔꯤ
ৱারিদা	ꯋꯥꯔꯤꯗꯥ
ৱারিবসি	ꯋꯥꯔꯤꯕꯁꯤ
ৱারিশিং	ꯋꯥꯔꯤꯁꯤꯡ
ৱারিয়র	ꯋꯥꯔꯤꯌꯔ
ৱারিয়রশিং	ꯋꯥꯔꯤꯌꯔꯁꯤꯡ
ৱারিয়রশিংগী	ꯋꯥꯔꯤꯌꯔꯁꯤꯡꯒꯤ
ৱারিয়রশিংবু	ꯋꯥꯔꯤꯌꯔꯁꯤꯡꯕꯨ
ৱারী	ꯋꯥꯔꯤ
ৱারীগা	ꯋꯥꯔꯤꯒꯥ
ৱারীগী	ꯋꯥꯔꯤꯒꯤ
ৱারীদা	ꯋꯥꯔꯤꯗꯥ
ৱারীদু	ꯋꯥꯔꯤꯗꯨ
ৱারীশিং	ꯋꯥꯔꯤꯁꯤꯡ
ৱারীশিংগী	ꯋꯥꯔꯤꯁꯤꯡꯒꯤ
ৱারে	ꯋꯥꯔꯦ
ৱারেং	ꯋꯥꯔꯦꯡ
ৱারেংদা	ꯋꯥꯔꯦꯡꯗꯥ
ৱারেংদু	ꯋꯥꯔꯦꯪꯗꯨ
ৱারেপ	ꯋꯥꯔꯦꯞ
ৱারেপকা	ꯋꯥꯔꯦꯞꯀꯥ
ৱারেপনি	ꯋꯥꯔꯦꯞꯅꯤ
ৱারেপশিং	ꯋꯥꯔꯦꯞꯁꯤꯡ
ৱারেপসু	ꯋꯥꯔꯦꯞꯁꯨ
ৱারেম	ꯋꯥꯔꯦꯃ
ৱার্ক	ꯋꯥꯔꯛ
ৱার্কতা	ꯋꯥꯔꯛꯇꯥ
ৱার্কর	ꯋꯥꯔꯀꯔ
ৱার্করশিং	ꯋꯥꯔꯀꯔꯁꯤꯡ
ৱার্করশিংগী	ꯋꯥꯔꯀꯔꯁꯤꯡꯒꯤ
ৱার্করশিংদসু	ꯋꯥꯔꯀꯔꯁꯤꯡꯗꯁꯨ
ৱার্করশিংদা	ꯋꯥꯔꯀꯔꯁꯤꯡꯗꯥ
ৱার্করশিংনা	ꯋꯥꯔꯀꯔꯁꯤꯡꯅꯥ
ৱার্কশিং	ꯋꯥꯔꯛꯁꯤꯡ
ৱার্কস	ꯋꯥꯔꯛꯁ
ৱার্কিং	ꯋꯥꯔꯀꯤꯡ
ৱার্ড	ꯋꯥꯔꯗ
ৱার্ডতা	ꯋꯥꯔꯗꯇꯥ
ৱার্দ	ꯋꯥꯔꯗ
ৱার্দকী	ꯋꯥꯔꯗꯀꯤ
ৱার্দতা	ꯋꯥꯔꯗꯇꯥ
ৱার্দশিং	ꯋꯥꯔꯗꯁꯤꯡ
ৱার্দশিংদা	ꯋꯥꯔꯗꯁꯤꯡꯗꯥ
ৱার্দেন	ꯋꯥꯔꯗꯦꯟ
ৱার্নিং	ꯋꯥꯔꯅꯤꯟ
ৱার্মিংগী	ꯋꯥꯔꯃꯤꯡꯒꯤ
ৱাল	ꯋꯥꯜ
ৱালদা	ꯋꯥꯜꯗꯥ
ৱাশক	ꯋꯥꯁꯛ
ৱাশকখি	ꯋꯥꯁꯛꯈꯤ
ৱাশকখিবশিং	ꯋꯥꯁꯛꯈꯤꯕꯁꯤꯡ
ৱাশকখিবা	ꯋꯥꯁꯛꯈꯤꯕꯥ
ৱাশকখ্রে	ꯋꯥꯁꯛꯈꯔꯦ
ৱাশকপগা	ꯋꯥꯁꯛꯄꯒꯥ
ৱাশকশিং	ꯋꯥꯁꯛꯁꯤꯡ
ৱাশিং	ꯋꯥꯁꯤꯡ
ৱাশিংটন	ꯋꯥꯁꯤꯡꯇꯟ
ৱাশিংটনদা	ꯋꯥꯁꯤꯡꯇꯟꯗꯥ
ৱাশিংটননা	ꯋꯥꯁꯤꯡꯇꯟꯅꯥ
ৱাস	ꯋꯥꯁ
ৱাসু	ꯋꯥꯁꯨ
ৱাহং	ꯋꯥꯍꯪ
ৱাহংগী	ꯋꯥꯍꯪꯒꯤ
ৱাহংশিং	ꯋꯥꯍꯪꯁꯤꯡ
ৱাহংশিংগী	ꯋꯥꯍꯪꯁꯤꯡꯒꯤ
ৱাহেং	ꯋꯥꯍꯦꯪ
ৱাহেংবম	ꯋꯥꯍꯦꯡꯕꯝ
ৱাহেংবমনা	ꯋꯥꯍꯦꯡꯕꯝꯅꯥ
ৱাহৈ	ꯋꯥꯍꯩ
ৱাহৈনা	ꯋꯥꯍꯩꯅꯥ
ৱাহৈশিং	ꯋꯥꯍꯩꯁꯤꯡ
ৱাৎকনি	ꯋꯥꯠꯀꯅꯤ
ৱাৎত	ꯋꯥꯠꯇ
ৱাৎতনা	ꯋꯥꯠꯇꯅꯥ
ৱাৎপগী	ꯋꯥꯠꯄꯒꯤ
ৱাৎপগুম	ꯋꯥꯠꯄꯒꯨꯝ
ৱাৎপদগী	ꯋꯥꯠꯄꯗꯒꯤ
ৱাৎপদা	ꯋꯥꯠꯄꯗꯥ
ৱাৎপা	ꯋꯥꯠꯄꯥ
ৱাৎলি	ꯋꯥꯠꯂꯤ
ৱাৎলিঙৈ	ꯋꯥꯠꯂꯤꯉꯩ
ৱাৎলিঙৈদা	ꯋꯥꯠꯂꯤꯉꯩꯗꯥ
ৱাৎলিবা	ꯋꯥꯠꯂꯤꯕꯥ
ৱাৎলে	ꯋꯥꯠꯂꯦ
ৱায়র	ꯋꯥꯌꯔ
ৱায়েন	ꯋꯥꯌꯦꯟ
ৱায়েল	ꯋꯥꯌꯦꯜ
ৱি	ꯋꯤ
ৱিং	ꯋꯤꯡ
ৱিংগী	ꯋꯤꯡꯒꯤ
ৱিংনা	ꯋꯤꯡꯅꯥ
ৱিক	ꯋꯤꯛ
ৱিকর	ꯋꯤꯀꯔ
ৱিকেট	ꯋꯤꯀꯦꯇ
ৱিক্লি	ꯋꯤꯛꯂꯤ
ৱিন	ꯋꯤꯟ
ৱিন্টর	ꯋꯤꯟꯇꯔ
ৱিন্নর	ꯋꯤꯟꯅꯔ
ৱিমেন	ꯋꯤꯃꯦꯟ
ৱিমেন্স	ꯋꯤꯃꯦꯟꯁ
ৱিল	ꯋꯤꯜ
ৱুদ	ꯋꯨꯗ
ৱুমেন	ꯋꯨꯃꯦꯅ
ৱুসু	ꯋꯨꯁꯨ
ৱুহান	ꯋꯨꯍꯥꯟ
ৱুহানগী	ꯋꯨꯍꯥꯟꯒꯤ
ৱুহানদগী	ꯋꯨꯍꯥꯟꯗꯒꯤ
ৱুহানদা	ꯋꯨꯍꯥꯟꯗꯥ
ৱে	ꯋꯦ
ৱেজেস	ꯋꯦꯖꯦꯁ
ৱেট	ꯋꯦꯇ
ৱেটিং	ꯋꯦꯇꯤꯡ
ৱেথ	ꯋꯦꯊ
ৱেব	ꯋꯦꯕ
ৱেবকী	ꯋꯦꯕꯀꯤ
ৱেবসাইট	ꯋꯦꯕꯁꯥꯏꯇ
ৱেবিনার	ꯋꯦꯕꯤꯅꯥꯔ
ৱেল	ꯋꯦꯜ
ৱেলকম	ꯋꯦꯜꯀꯝ
ৱেলদিং	ꯋꯦꯜꯗꯤꯡ
ৱেলফিয়র	ꯋꯦꯜꯐꯤꯌꯔ
ৱেলফিয়ার	ꯋꯦꯜꯐꯤꯌꯥꯔ
ৱেলফিয়ারগী	ꯋꯦꯜꯐꯤꯌꯥꯔꯒꯤ
ৱেলফিয়ারনা	ꯋꯦꯜꯐꯤꯌꯥꯔꯅꯥ
ৱেলস	ꯋꯦꯜꯁ
ৱেষ্ট	ꯋꯦꯁ꯭ꯇ
ৱেষ্টকী	ꯋꯦꯁ꯭ꯇꯀꯤ
ৱেষ্টতগী	ꯋꯦꯁꯠꯇꯒꯤ
ৱেষ্টতনা	ꯋꯦꯁꯠꯇꯅꯥ
ৱেষ্টতা	ꯋꯦꯁꯠꯇꯥ
ৱেষ্টনা	ꯋꯦꯁꯇꯅꯥ
ৱেষ্টর্ন	ꯋꯦꯁꯇ꯭ꯔꯅ